종목코드,종목명,시작일 기준가,종료일 종가,대비,등락률,거래량,거래대금
"060310","3S","2885","2915","30","1.04","13165511","39264532530"
"095570","AJ네트웍스","6520","7870","1350","20.71","2253231","17056256570"
"006840","AK홀딩스","16250","16300","50","0.31","263668","4260314200"
"054620","APS홀딩스","8190","10700","2510","30.65","1929638","18867139460"
"265520","AP시스템","16900","18650","1750","10.36","1528105","26726114750"
"211270","AP위성","11500","11750","250","2.17","6617346","79324134600"
"027410","BGF","4170","4315","145","3.48","2865974","12010525975"
"282330","BGF리테일","189500","173000","-16500","-8.71","806544","146142286000"
"032790","BNGT","4075","4075","0","0.00","0","0"
"138930","BNK금융지주","6630","6820","190","2.87","21511768","142404601616"
"001460","BYC","404500","416000","11500","2.84","2064","853853000"
"001465","BYC우","157000","156000","-1000","-0.64","1365","212689500"
"013720","CBI","1365","1960","595","43.59","50245863","102532363490"
"001040","CJ","77700","80300","2600","3.35","599549","47107805600"
"079160","CJ CGV","21950","21400","-550","-2.51","4693479","98776792250"
"035760","CJ ENM","95800","101300","5500","5.74","1869355","186726684700"
"311690","CJ 바이오사이언스","31450","34650","3200","10.17","433975","14591447950"
"00104K","CJ4우(전환)","70400","71500","1100","1.56","157752","11071093500"
"000120","CJ대한통운","122000","127000","5000","4.10","1110968","129657996500"
"011150","CJ씨푸드","3190","3400","210","6.58","7051829","24032381450"
"011155","CJ씨푸드1우","29750","28550","-1200","-4.03","5054","142095550"
"001045","CJ우","48050","49600","1550","3.23","40861","1966914250"
"097950","CJ제일제당","389000","420500","31500","8.10","967909","391489062500"
"097955","CJ제일제당 우","165500","176500","11000","6.65","30735","5266484000"
"051500","CJ프레시웨이","39150","41500","2350","6.00","1777759","67998557050"
"058820","CMG제약","2620","2865","245","9.35","12366809","33872818340"
"023460","CNH","1795","1945","150","8.36","338957","634164280"
"056730","CNT85","3100","3100","0","0.00","0","0"
"065770","CS","2095","2225","130","6.21","4619215","10323064295"
"083660","CSA 코스믹","1525","1450","-75","-4.92","957162","1400993970"
"000590","CS홀딩스","59400","66400","7000","11.78","230994","15052424800"
"012030","DB","797","832","35","4.39","5316090","4318001834"
"404950","DB금융스팩10호","2100","2110","10","0.48","229011","483320605"
"367340","DB금융스팩8호","2135","2130","-5","-0.23","249157","528821720"
"367360","DB금융스팩9호","2155","2125","-30","-1.39","197265","417593585"
"016610","DB금융투자","5020","5220","200","3.98","671936","3373231250"
"005830","DB손해보험","58200","62900","4700","8.08","3204176","197103068855"
"000990","DB하이텍","49000","42900","-6100","-12.45","20469946","888128899750"
"000995","DB하이텍1우","93700","71100","-22600","-24.12","8669","703823900"
"139130","DGB금융지주","7790","7600","-190","-2.44","7796817","59266553680"
"001530","DI동일","16100","19900","3800","23.60","2035497","35982236800"
"000210","DL","67300","67600","300","0.45","2702477","179521572000"
"001880","DL건설","20750","22050","1300","6.27","446394","9511260150"
"000215","DL우","39100","39900","800","2.05","41559","1639911450"
"375500","DL이앤씨","40250","43800","3550","8.82","4771592","193213321050"
"37550L","DL이앤씨2우(전환)","34250","34950","700","2.04","46891","1596306550"
"37550K","DL이앤씨우","28550","30000","1450","5.08","67964","1955781250"
"068790","DMS","5050","5580","530","10.50","1200011","6445041195"
"007340","DN오토모티브","53000","56000","3000","5.66","409508","21838966950"
"004840","DRB동일","4520","4605","85","1.88","270358","1230680510"
"241520","DSC인베스트먼트","4180","4645","465","11.12","6328015","28983817325"
"155660","DSR","5400","6130","730","13.52","1672075","9550937240"
"069730","DSR제강","4795","5360","565","11.78","1242738","6216272055"
"017940","E1","44950","45200","250","0.56","188460","8302256750"
"245620","EDGC","3280","2855","-425","-12.96","44095904","150104364780"
"037370","EG","9200","10600","1400","15.22","803285","7935645310"
"278990","EMB","5490","5600","110","2.00","17842","90418330"
"365550","ESR켄달스퀘어리츠","5460","5520","60","1.10","5014599","26358379034"
"050120","ES큐브","3900","3840","-60","-1.54","786641","3069111100"
"084180","EV수성","1525","1370","-155","-10.16","22181676","32957053970"
"383220","F&F","138000","154500","16500","11.96","2714023","405871437000"
"007700","F&F홀딩스","18800","19900","1100","5.85","795469","15540597750"
"214270","FSN","4420","5080","660","14.93","21199699","111194447460"
"130500","GH신소재","4910","4940","30","0.61","30710359","171272597310"
"114090","GKL","13950","14950","1000","7.17","5022238","71174635250"
"900290","GRT","1240","1305","65","5.24","2691624","3435058835"
"078930","GS","39650","42450","2800","7.06","3811041","153434907800"
"083450","GST","21750","21850","100","0.46","1596247","34996528350"
"006360","GS건설","29550","32200","2650","8.97","15640943","461421464400"
"001250","GS글로벌","3240","3890","650","20.06","229618793","841383690900"
"007070","GS리테일","25500","25650","150","0.59","4897242","120428041500"
"078935","GS우","34550","34900","350","1.01","58736","2008999600"
"297890","HB솔루션","13100","13600","500","3.82","1156357","15401857800"
"078150","HB테크놀러지","1865","2035","170","9.12","13778883","27842212775"
"012630","HDC","6540","6970","430","6.57","1231301","8248300020"
"039570","HDC랩스","8460","8810","350","4.14","890005","8270770640"
"089470","HDC현대EP","3865","4230","365","9.44","432406","1749679920"
"294870","HDC현대산업개발","11450","13150","1700","14.85","6950213","82792045450"
"267250","HD현대","52900","58300","5400","10.21","3174830","171601860750"
"097230","HJ중공업","6800","6890","90","1.32","276357","1881360350"
"195940","HK이노엔","40150","43850","3700","9.22","12445837","530747128050"
"028300","HLB","40300","47450","7150","17.74","26032586","1141693952300"
"003580","HLB글로벌","10100","9680","-420","-4.16","13460491","131677445540"
"343090","HLB사이언스","4100","4255","155","3.78","320384","1244801470"
"067630","HLB생명과학","13000","14200","1200","9.23","26052701","347885360750"
"047920","HLB제약","15650","16500","850","5.43","7821600","119427943850"
"115450","HLB테라퓨틱스","13400","12100","-1300","-9.70","5130694","64119765400"
"011200","HMM","25100","25400","300","1.20","39351971","953287284950"
"036640","HRS","6190","6700","510","8.24","2671548","16904093990"
"082740","HSD엔진","7298","8670","1372","18.80","9057944","80429841560"
"335870","IBKS제12호스팩","2460","2875","415","16.87","6017886","15153731955"
"351340","IBKS제13호스팩","2030","2020","-10","-0.49","1339481","2762686305"
"388790","IBKS제16호스팩","2225","2225","0","0.00","0","0"
"405350","IBKS제17호스팩","2280","2265","-15","-0.66","458900","1051965715"
"003560","IHQ","719","728","9","1.25","11351169","8559284765"
"095340","ISC","32550","31450","-1100","-3.38","4478217","147821058400"
"099520","ITX-AI","1285","1285","0","0.00","0","0"
"175330","JB금융지주","7130","7360","230","3.23","5813474","42407194400"
"950170","JTC","2845","2695","-150","-5.27","658691","1772944655"
"234080","JW생명과학","13350","13700","350","2.62","270079","3674898950"
"067290","JW신약","3845","4145","300","7.80","8711358","35780107860"
"001060","JW중외제약","24050","23050","-1000","-4.16","1724705","42082526850"
"001067","JW중외제약2우B","70300","70500","200","0.28","2852","202825700"
"001065","JW중외제약우","36600","36550","-50","-0.14","5644","203467550"
"096760","JW홀딩스","3360","3450","90","2.68","704344","2434771750"
"035900","JYP Ent.","53400","57800","4400","8.24","8257078","462635646100"
"318000","KBG","5930","6580","650","10.96","1029918","6441736410"
"024840","KBI메탈","1715","1835","120","7.00","2623488","4722685395"
"105560","KB금융","47000","51300","4300","9.15","25522360","1212889620851"
"024120","KB오토시스","5620","5470","-150","-2.67","1299916","7039020450"
"002380","KCC","287500","307000","19500","6.78","771896","225253182000"
"021320","KCC건설","6870","7310","440","6.40","421367","2894494860"
"344820","KCC글라스","44800","49400","4600","10.27","494164","22783444900"
"036670","KCI","8190","8890","700","8.55","209272","1800652540"
"009070","KCTC","4460","5170","710","15.92","8269063","43507334420"
"009440","KC그린홀딩스","5020","4965","-55","-1.10","2662431","13033374770"
"112190","KC산업","3420","3695","275","8.04","15758","53561315"
"119650","KC코트렐","4230","4625","395","9.34","1188824","5270439860"
"044180","KD","1035","1070","35","3.38","1590643","1626033685"
"092220","KEC","2545","2730","185","7.27","44088175","119210736850"
"151860","KG ETS","15850","15700","-150","-0.95","27220159","417953479750"
"046440","KG모빌리언스","7130","7270","140","1.96","3742823","26147536990"
"016380","KG스틸","13150","12600","-550","-4.18","14532579","180895593750"
"035600","KG이니시스","13700","14100","400","2.92","2472803","33888010250"
"001390","KG케미칼","26100","28850","2750","10.54","7619420","215863051350"
"226360","KH 건설","919","863","-56","-6.09","171391517","151812095119"
"111870","KH 전자","753","824","71","9.43","34275692","26440166588"
"033180","KH 필룩스","1525","1510","-15","-0.98","16999568","25172991060"
"060720","KH바텍","18200","19600","1400","7.69","4414229","88970695300"
"001940","KISCO홀딩스","14050","14300","250","1.78","408179","5700656500"
"058400","KNN","1010","1070","60","5.94","7200936","7510871599"
"114450","KPX생명과학","5280","5610","330","6.25","26521801","170855250580"
"025000","KPX케미칼","47950","51400","3450","7.19","49755","2462222900"
"092230","KPX홀딩스","59600","60600","1000","1.68","15288","913496600"
"000040","KR모터스","633","716","83","13.11","57434050","44575952773"
"044450","KSS해운","9650","10800","1150","11.92","686770","6881087830"
"030200","KT","36650","38600","1950","5.32","16001290","600593225725"
"033780","KT&G","80700","81200","500","0.62","5081402","413555568900"
"058850","KTcs","2015","2385","370","18.36","19620594","45148268250"
"058860","KTis","2595","2805","210","8.09","7386964","19821862390"
"060370","KT서브마린","6450","6970","520","8.06","13817390","94080095370"
"122450","KX","7690","7860","170","2.21","982219","7484238620"
"052900","KX하이텍","1380","1495","115","8.33","10237071","15285895645"
"093050","LF","16150","17150","1000","6.19","946731","15690928350"
"003550","LG","78400","81600","3200","4.08","3557664","280198779400"
"034220","LG디스플레이","15250","16350","1100","7.21","28209736","430902175850"
"051900","LG생활건강","714000","743000","29000","4.06","1244157","923278815271"
"051905","LG생활건강우","330500","363500","33000","9.98","109343","38330348000"
"373220","LG에너지솔루션","388000","469500","81500","21.01","12409271","5082685045000"
"003555","LG우","61400","62900","1500","2.44","40650","2504896200"
"032640","LG유플러스","12300","12550","250","2.03","15634536","192870282158"
"011070","LG이노텍","338000","343500","5500","1.63","4859054","1674800690000"
"066570","LG전자","92000","94700","2700","2.93","13072637","1218388258500"
"066575","LG전자우","44800","46600","1800","4.02","395331","18067231000"
"037560","LG헬로비전","5610","5470","-140","-2.50","12387885","70044193510"
"051910","LG화학","540000","672000","132000","24.44","6099866","3541639801491"
"051915","LG화학우","254500","327000","72500","28.49","326616","91657894058"
"079550","LIG넥스원","69400","90800","21400","30.84","5588874","462786363600"
"006260","LS","55400","61400","6000","10.83","3055934","169832337100"
"010120","LS ELECTRIC","53200","58700","5500","10.34","3547032","194495118300"
"000680","LS네트웍스","2650","3135","485","18.30","1865738","5571921250"
"229640","LS전선아시아","6920","7370","450","6.50","5765375","42414582530"
"108320","LX세미콘","95500","92500","-3000","-3.14","4542750","425993236900"
"001120","LX인터내셔널","29600","33500","3900","13.18","5912475","184207315550"
"108670","LX하우시스","42100","45400","3300","7.84","528100","22644051200"
"108675","LX하우시스우","20400","21950","1550","7.60","64930","1308091400"
"383800","LX홀딩스","8950","8670","-280","-3.13","2930836","25404052630"
"38380K","LX홀딩스1우","12150","12250","100","0.82","67880","813506750"
"023150","MH에탄올","8550","9090","540","6.32","3312557","31554217490"
"035420","NAVER","249000","266500","17500","7.03","14879540","3753756545094"
"160550","NEW","7150","8520","1370","19.16","7332541","57598262930"
"053290","NE능률","5410","5620","210","3.88","20896145","135664380340"
"181710","NHN","27650","29500","1850","6.69","2247689","63612740300"
"104200","NHN벅스","9070","9270","200","2.21","6654039","63711447730"
"060250","NHN한국사이버결제","12850","13650","800","6.23","14051672","194968417700"
"400760","NH올원리츠","4540","4630","90","1.98","1099351","4899919100"
"005940","NH투자증권","9230","10000","770","8.34","12911762","122470093220"
"005945","NH투자증권우","9210","9920","710","7.71","731912","6951240290"
"338100","NH프라임리츠","4660","4665","5","0.11","621415","2856255040"
"034310","NICE","14600","13450","-1150","-7.88","1153416","16102612150"
"030190","NICE평가정보","14250","16500","2250","15.79","2037802","30821873783"
"008260","NI스틸","4850","5030","180","3.71","2513592","12452782470"
"004250","NPC","8770","9720","950","10.83","38206630","364372142020"
"004255","NPC우","4725","5070","345","7.30","6611377","34729424670"
"010060","OCI","127000","127000","0","0.00","14173943","1663862646500"
"178920","PI첨단소재","33850","38850","5000","14.77","2481903","88495864450"
"024940","PN풍년","4910","5690","780","15.89","4699565","24218374885"
"005490","POSCO홀딩스","231000","253000","22000","9.52","5971247","1399110996630"
"218410","RFHIC","21900","23750","1850","8.45","2135872","48156185250"
"327260","RF머트리얼즈","11150","10800","-350","-3.14","347197","3824909800"
"091340","S&K폴리텍","4235","4500","265","6.26","191689","832659660"
"010950","S-Oil","93000","86300","-6700","-7.20","9531939","854030891872"
"010955","S-Oil우","58000","56700","-1300","-2.24","300949","17260266300"
"019550","SBI인베스트먼트","1550","1470","-80","-5.16","20719082","30098283555"
"950110","SBI핀테크솔루션즈","4305","4825","520","12.08","125596","577932030"
"034120","SBS","42600","43600","1000","2.35","935643","38941415500"
"046140","SBS콘텐츠허브","6030","7020","990","16.42","2104636","14833138750"
"151910","SBW생명과학","3800","3250","-550","-14.47","5370577","19222336880"
"036120","SCI평가정보","3340","2965","-375","-11.23","18445735","62530198150"
"099220","SDN","2510","3050","540","21.51","275374838","807697468440"
"036540","SFA반도체","5140","5350","210","4.09","34558332","185084784875"
"255220","SG","1595","1780","185","11.60","25921453","47886380575"
"040610","SG&G","1995","2150","155","7.77","9341019","19960385550"
"049470","SGA","943","941","-2","-0.21","4113790","3861353989"
"184230","SGA솔루션즈","865","986","121","13.99","36918828","37703059797"
"005090","SGC에너지","33600","38400","4800","14.29","1512514","54086695100"
"016250","SGC이테크건설","43500","50600","7100","16.32","113906","5293958050"
"001380","SG글로벌","1360","1490","130","9.56","2794386","4131837965"
"004060","SG세계물산","560","619","59","10.54","16700196","9834387478"
"001770","SHD","30050","32250","2200","7.32","200624","6093145100"
"002360","SH에너지화학","1000","1110","110","11.00","103954459","111191043067"
"009160","SIMPAC","6250","6560","310","4.96","2762260","17325150620"
"123700","SJM","3500","3660","160","4.57","187713","676673715"
"025530","SJM홀딩스","3005","3115","110","3.66","1323007","4004883395"
"034730","SK","208500","227000","18500","8.87","2516608","542330455488"
"337450","SK5호스팩","5040","3410","-1630","-32.34","64367866","322730208450"
"340350","SK6호스팩","2265","2105","-160","-7.06","7886928","17126247390"
"011790","SKC","132000","133500","1500","1.14","4316682","568612960500"
"018670","SK가스","112000","116500","4500","4.02","259851","29011193000"
"001740","SK네트웍스","4250","4370","120","2.82","8237621","35914159515"
"001745","SK네트웍스우","57600","61800","4200","7.29","5168","304124400"
"006120","SK디스커버리","34800","36300","1500","4.31","336674","11966060350"
"006125","SK디스커버리우","30250","30800","550","1.82","35937","1095646050"
"210980","SK디앤디","24800","28250","3450","13.91","460012","11719680900"
"068400","SK렌터카","8260","8880","620","7.51","3408024","31749607820"
"395400","SK리츠","5710","5490","-220","-3.85","6686922","35881131580"
"302440","SK바이오사이언스","140000","124500","-15500","-11.07","20570943","2810941939500"
"326030","SK바이오팜","78800","80500","1700","2.16","2087756","164240254900"
"402340","SK스퀘어","39800","43400","3600","9.05","6677610","277398531870"
"260870","SK시그넷","48350","51300","2950","6.10","156371","8092403500"
"361610","SK아이이테크놀로지","82000","93800","11800","14.39","11008389","926515318800"
"03473K","SK우","184500","196000","11500","6.23","13491","2505162500"
"096770","SK이노베이션","171500","194000","22500","13.12","8261661","1490726872500"
"096775","SK이노베이션우","110500","120000","9500","8.60","44799","5112459500"
"001510","SK증권","726","773","47","6.47","21279049","15865842582"
"001515","SK증권우","2980","3095","115","3.86","113318","341043145"
"285130","SK케미칼","102000","106000","4000","3.92","1317919","138019238000"
"28513K","SK케미칼우","51700","53200","1500","2.90","140826","7439666200"
"017670","SK텔레콤","54000","52700","-1300","-2.41","11001517","589707991301"
"000660","SK하이닉스","94800","94300","-500","-0.53","66142695","6467121631862"
"048550","SM C&C","3350","4100","750","22.39","50745896","197633985480"
"063440","SM Life Design","2130","2405","275","12.91","20447072","48207785840"
"064960","SNT모티브","41000","42050","1050","2.56","805575","34587946400"
"100840","SNT에너지","16550","17800","1250","7.55","605376","9836853250"
"003570","SNT중공업","6800","9170","2370","34.85","10999925","92184242800"
"036530","SNT홀딩스","15450","15600","150","0.97","494779","7923097550"
"005610","SPC삼립","80900","86600","5700","7.05","306824","25067000800"
"011810","STX","3275","3555","280","8.55","761805","2514524210"
"077970","STX엔진","13200","15750","2550","19.32","2812034","40758723800"
"071970","STX중공업","4260","4685","425","9.98","1444480","6248838375"
"002820","SUN&L","4590","4570","-20","-0.44","276805","1233984395"
"289080","SV인베스트먼트","2655","2900","245","9.23","21151527","62255534195"
"084870","TBH글로벌","1980","2025","45","2.27","1928883","3924016835"
"002710","TCC스틸","12600","14200","1600","12.70","16813655","228381684350"
"089230","THE E&M","456","543","87","19.08","32057389","17260412007"
"161570","THE MIDONG","1235","1245","10","0.81","759777","936483875"
"192410","THQ","4765","4560","-205","-4.30","8045613","38633437515"
"032540","TJ미디어","5830","6620","790","13.55","3426913","22046614740"
"022220","TKG애강","1880","1875","-5","-0.27","26626403","51795480220"
"069260","TKG휴켐스","19900","20100","200","1.01","3183836","62343077250"
"048770","TPC","4795","4885","90","1.88","15413066","75870165775"
"246690","TS인베스트먼트","2580","2345","-235","-9.11","34363035","83229348530"
"317240","TS트릴리온","853","870","17","1.99","7620076","6452639334"
"002900","TYM","2510","2425","-85","-3.39","166389348","428344907700"
"038340","UCI","1335","1335","0","0.00","0","0"
"073570","WI","1020","920","-100","-9.80","13731863","13577610543"
"024070","WISCOM","3300","3200","-100","-3.03","373080","1190770305"
"057030","YBM넷","4060","4695","635","15.64","16880750","87173260510"
"037270","YG PLUS","5470","6810","1340","24.50","17969781","112179563400"
"040300","YTN","3650","3620","-30","-0.82","276455","993626070"
"051390","YW","3680","3855","175","4.76","217761","814223620"
"052220","iMBC","3180","3460","280","8.81","1173950","3808575195"
"079940","가비아","11100","12200","1100","9.91","438126","5094356900"
"078890","가온미디어","8470","8410","-60","-0.71","3981601","33802273030"
"000500","가온전선","23150","20950","-2200","-9.50","383087","8400225450"
"399720","가온칩스","24650","27000","2350","9.53","13080562","336697710950"
"036620","감성코퍼레이션","1625","1775","150","9.23","9770134","16974018135"
"000860","강남제비스코","21050","23450","2400","11.40","152827","3425413750"
"217730","강스템바이오텍","2845","3895","1050","36.91","5085815","17973886460"
"035250","강원랜드","25450","25600","150","0.59","10558153","261601582350"
"114190","강원에너지","6370","5130","-1240","-19.47","6887671","38212609140"
"094480","갤럭시아머니트리","6080","7570","1490","24.51","39245534","301660559010"
"011420","갤럭시아에스엠","1865","2040","175","9.38","7104254","13855705895"
"039240","경남스틸","3275","3635","360","10.99","2910127","9808414730"
"053950","경남제약","2655","2550","-105","-3.95","19811553","57475768145"
"002100","경농","10850","11650","800","7.37","942340","10501448000"
"009450","경동나비엔","38450","38950","500","1.30","765308","30110043150"
"267290","경동도시가스","20550","23650","3100","15.09","1339299","30451650600"
"012320","경동인베스트","34000","34500","500","1.47","63556","2225847800"
"011040","경동제약","8930","8860","-70","-0.78","1656081","15026372340"
"000050","경방","12300","13150","850","6.91","107748","1386998350"
"214390","경보제약","7140","7180","40","0.56","277633","1995872360"
"012610","경인양행","5460","6030","570","10.44","2947996","17036417030"
"009140","경인전자","25500","27900","2400","9.41","74384","1960924850"
"024910","경창산업","2430","2610","180","7.41","1051569","2655727835"
"013580","계룡건설","25000","26200","1200","4.80","950233","22997848200"
"012200","계양전기","3060","3295","235","7.68","4622297","15168692535"
"012205","계양전기우","6670","5870","-800","-11.99","429388","2710152430"
"002140","고려산업","7070","4910","-2160","-30.55","29951093","180788518640"
"198440","고려시멘트","3450","3730","280","8.12","30099797","112738531535"
"049720","고려신용정보","11600","10600","-1000","-8.62","18608929","222089702050"
"010130","고려아연","463000","581000","118000","25.49","1103417","551162553000"
"002240","고려제강","20400","21550","1150","5.64","627008","12865545850"
"014570","고려제약","7700","8150","450","5.84","633487","5086669880"
"348150","고바이오랩","12750","13950","1200","9.41","744013","10182517150"
"098460","고영","13450","14700","1250","9.29","4798848","66562135605"
"035290","골드앤에스","2410","2430","20","0.83","9279943","24461018255"
"038530","골드퍼시픽","674","665","-9","-1.34","49889411","38835370207"
"900280","골든센츄리","371","386","15","4.04","35567700","14204545614"
"215000","골프존","139900","138700","-1200","-0.86","970363","135664189400"
"121440","골프존뉴딘홀딩스","7050","6930","-120","-1.70","882762","6023100210"
"183410","골프존데카","4390","4480","90","2.05","14412","61098520"
"366030","공구우먼","31600","11400","-20200","-63.92","34566902","513900988350"
"076340","관악산업","6700","6270","-430","-6.42","31543","164882300"
"009290","광동제약","6390","6710","320","5.01","8289738","57364486960"
"014200","광림","1490","1435","-55","-3.69","28561710","41027332110"
"017040","광명전기","3170","2930","-240","-7.57","19531145","58688320180"
"029480","광무","2855","3715","860","30.12","3783655","13915956210"
"017900","광전자","2260","2475","215","9.51","1595499","3738289125"
"037710","광주신세계","33300","33600","300","0.90","107884","3554565300"
"026910","광진실업","4895","5800","905","18.49","1254615","7077576105"
"355150","교보10호스팩","2240","2240","0","0.00","245621","549751790"
"397880","교보11호스팩","2145","2130","-15","-0.70","324126","696562715"
"421800","교보12호스팩","2105","2115","10","0.48","454159","961763775"
"331520","교보9호스팩","2470","2265","-205","-8.30","23910334","60252275735"
"030610","교보증권","6350","6430","80","1.26","727867","4553143460"
"339770","교촌에프앤비","11800","12200","400","3.39","749857","8907046600"
"053270","구영테크","3275","3375","100","3.05","17931266","61329685215"
"007690","국도화학","48850","51800","2950","6.04","548506","27057668350"
"005320","국동","1785","1805","20","1.12","27879318","55431104655"
"001140","국보","1190","1075","-115","-9.66","21092170","23732252010"
"066620","국보디자인","17000","17850","850","5.00","400058","6954640200"
"043650","국순당","8830","9410","580","6.57","1317501","11951932720"
"006050","국영지앤엠","1530","1635","105","6.86","10968103","18335573515"
"060480","국일신동","2970","3665","695","23.40","16462746","64961264150"
"078130","국일제지","2615","2720","105","4.02","9136674","23839457095"
"307750","국전약품","7380","8110","730","9.89","71975041","659708024480"
"002720","국제약품","5770","5600","-170","-2.95","11424779","66990310380"
"243870","굿센","15000","15500","500","3.33","2899","45532350"
"035080","그래디언트","18000","19450","1450","8.06","1633666","29970148200"
"204020","그리티","3145","3335","190","6.04","5765231","19026978175"
"083420","그린케미칼","7080","8990","1910","26.98","24552638","220232616680"
"186230","그린플러스","12000","13500","1500","12.50","878291","11139218400"
"014530","극동유화","3615","3765","150","4.15","2448007","8921074485"
"900070","글로벌에스엠","800","781","-19","-2.38","8039092","6388312644"
"204620","글로벌텍스프리","2475","2460","-15","-0.61","4772256","12483665225"
"019660","글로본","2490","2935","445","17.87","6083570","16536044690"
"014280","금강공업","7140","7460","320","4.48","2077256","14630895410"
"014285","금강공업우","12900","13050","150","1.16","26208","334139250"
"053260","금강철강","7120","7050","-70","-0.98","1954364","13499555700"
"008870","금비","71100","71200","100","0.14","49873","3732187800"
"001570","금양","5200","10300","5100","98.08","280952251","2425458403590"
"002990","금호건설","8010","8800","790","9.86","1223642","10047020390"
"002995","금호건설우","26550","28800","2250","8.47","6268","168280900"
"011780","금호석유","138000","133500","-4500","-3.26","2369484","298530526500"
"011785","금호석유우","87600","90300","2700","3.08","201003","17003425300"
"214330","금호에이치티","1290","1215","-75","-5.81","26619678","34359329740"
"001210","금호전기","1400","1410","10","0.71","4293969","5889510925"
"073240","금호타이어","3475","3725","250","7.19","5421634","19153848825"
"036190","금화피에스시","29850","30250","400","1.34","54223","1597056450"
"049080","기가레인","1525","1610","85","5.57","10952758","17289689140"
"035460","기산텔레콤","3425","4035","610","17.81","31565887","117647636730"
"092440","기신정기","3485","3760","275","7.89","368006","1324750760"
"000270","기아","76800","80800","4000","5.21","28702339","2318052714256"
"024110","기업은행","9210","9580","370","4.02","20123371","186481462680"
"013700","까뮤이앤씨","1910","2410","500","26.18","74194618","170649381140"
"308100","까스텔바작","9980","11000","1020","10.22","18323251","192403369880"
"004540","깨끗한나라","3505","3685","180","5.14","3465029","12736389720"
"004545","깨끗한나라우","19300","20050","750","3.89","7263","139719400"
"187790","나노","1095","1205","110","10.05","2418665","2813674490"
"286750","나노브릭","2065","2310","245","11.86","5609212","12820754320"
"121600","나노신소재","72100","89100","17000","23.58","4266910","342369160200"
"247660","나노씨엠에스","34500","30750","-3750","-10.87","4699724","165367852600"
"039860","나노엔텍","5440","5580","140","2.57","20760750","129333558210"
"091970","나노캠텍","1610","1610","0","0.00","0","0"
"244880","나눔테크","3035","3075","40","1.32","1345","3987535"
"288490","나라소프트","145","134","-11","-7.59","263286","33354103"
"051490","나라엠앤디","6420","7430","1010","15.73","5639343","40241988600"
"137080","나래나노텍","9110","9070","-40","-0.44","4409533","42231743020"
"190510","나무가","9430","10200","770","8.17","3544019","35817096340"
"242040","나무기술","1790","2055","265","14.80","21800984","47012475200"
"089600","나스미디어","22800","25700","2900","12.72","453837","11114857500"
"293580","나우IB","8550","8610","60","0.70","1359391","12254170600"
"257990","나우코스","5880","7100","1220","20.75","21210","137083670"
"138610","나이벡","24000","23800","-200","-0.83","1062527","26182238150"
"130580","나이스디앤비","7310","7900","590","8.07","788911","6709461710"
"036800","나이스정보통신","25200","25550","350","1.39","685189","17790882550"
"267320","나인테크","3605","4010","405","11.23","46432481","179383472065"
"001260","남광토건","11350","11650","300","2.64","2034262","22398302890"
"008350","남선알미늄","2130","2270","140","6.57","62390667","141353629350"
"008355","남선알미우","22050","23800","1750","7.94","81168","1903588500"
"004270","남성","2260","2445","185","8.19","2522347","6132270285"
"003920","남양유업","369500","385000","15500","4.19","12557","4658677000"
"003925","남양유업우","199500","213000","13500","6.77","2112","430134000"
"025860","남해화학","9650","10000","350","3.63","9823374","94836961100"
"111710","남화산업","7450","8070","620","8.32","190704","1452677230"
"091590","남화토건","7480","7870","390","5.21","1509229","11925517070"
"168330","내츄럴엔도텍","4265","4880","615","14.42","1047565","5102255435"
"094860","네오리진","717","734","17","2.37","22105809","17332970048"
"253590","네오셈","3430","3335","-95","-2.77","3527923","12064104235"
"212560","네오오토","6050","7480","1430","23.64","6221003","46409645560"
"095660","네오위즈","25900","27750","1850","7.14","7588894","209290003850"
"042420","네오위즈홀딩스","29450","33000","3550","12.05","2311509","74387278450"
"950220","네오이뮨텍","4520","5220","700","15.49","58773947","301672870010"
"311390","네오크레마","13800","14000","200","1.45","1848831","28302099600"
"085910","네오티스","5010","5450","440","8.78","1772061","9214261465"
"092730","네오팜","20150","20300","150","0.74","233011","4769569800"
"290660","네오펙트","2095","2200","105","5.01","1754387","3965361185"
"306620","네온테크","4405","4510","105","2.38","41361018","191487158445"
"153460","네이블","7180","7390","210","2.92","193102","1447757340"
"007390","네이처셀","18950","23250","4300","22.69","23809097","548546757500"
"033640","네패스","19250","20400","1150","5.97","2397992","46745724800"
"330860","네패스아크","28550","29150","600","2.10","845007","24056875600"
"005720","넥센","3470","3640","170","4.90","258267","916621880"
"005725","넥센우","3085","3040","-45","-1.46","88159","257101460"
"002350","넥센타이어","5520","6540","1020","18.48","3025152","18791658860"
"002355","넥센타이어1우B","2745","2930","185","6.74","392759","1075580200"
"089140","넥스턴바이오","2785","3350","565","20.29","57000706","194339090865"
"137940","넥스트아이","720","742","22","3.06","5222053","3947929302"
"396270","넥스트칩","14700","10950","-3750","-25.51","16797819","216865827800"
"348210","넥스틴","59000","56400","-2600","-4.41","1408651","85423195700"
"225570","넥슨게임즈","17450","22400","4950","28.37","21002188","435043949550"
"217270","넵튠","11650","15000","3350","28.76","7421311","115054354700"
"251270","넷마블","68700","71900","3200","4.66","4577413","321771126900"
"317860","노드메이슨","7300","8490","1190","16.30","2084","15469890"
"104620","노랑풍선","8230","7750","-480","-5.83","1262525","9537771360"
"090350","노루페인트","8360","9880","1520","18.18","5070899","47464877000"
"090355","노루페인트우","15000","17400","2400","16.00","27114","436854350"
"000320","노루홀딩스","10750","11650","900","8.37","253811","2885657700"
"000325","노루홀딩스우","25500","21500","-4000","-15.69","99935","2213232800"
"194700","노바렉스","29100","32700","3600","12.37","438203","13742664250"
"285490","노바텍","31850","32800","950","2.98","1089608","36691404900"
"229500","노브메타파마","12500","13400","900","7.20","31084","388546500"
"106520","노블엠앤비","3625","3990","365","10.07","6544257","25468974715"
"376930","노을","9230","7400","-1830","-19.83","6221239","49603119430"
"278650","노터스","8250","6770","-1480","-17.94","110905155","826752342890"
"006280","녹십자","177000","172500","-4500","-2.54","696555","123521547000"
"142280","녹십자엠에스","7760","7820","60","0.77","23957976","202167012750"
"234690","녹십자웰빙","8010","8200","190","2.37","1100516","9048696270"
"005250","녹십자홀딩스","19950","20600","650","3.26","2036642","42575116900"
"005257","녹십자홀딩스2우","56500","56400","-100","-0.18","130602","8080284400"
"065560","녹원씨엔아이","5770","5770","0","0.00","0","0"
"004370","농심","283000","297000","14000","4.95","471378","134101364000"
"072710","농심홀딩스","68400","68100","-300","-0.44","46028","3106126400"
"054050","농우바이오","9850","10150","300","3.05","631872","6334175850"
"069140","누리플랜","5840","5750","-90","-1.54","434425","2482661080"
"040160","누리플렉스","6840","6410","-430","-6.29","3333497","22766906250"
"332290","누보","2795","2305","-490","-17.53","13004818","31906028655"
"126870","뉴로스","2230","2230","0","0.00","0","0"
"060260","뉴보텍","1120","1345","225","20.09","51725914","64828956220"
"012340","뉴인텍","2970","4000","1030","34.68","81492865","322379600500"
"214870","뉴지랩파마","9080","14000","4920","54.19","9681346","111867547730"
"270870","뉴트리","13100","13500","400","3.05","964523","12442575500"
"144960","뉴파워프라즈마","4060","4570","510","12.56","1794578","8143874155"
"085670","뉴프렉스","4305","5190","885","20.56","10806655","53102115670"
"119860","다나와","17350","18900","1550","8.93","492977","8926993050"
"064260","다날","7170","7710","540","7.53","40893119","309270743620"
"093640","다믈멀티미디어","3720","4240","520","13.98","957154","3938681340"
"340360","다보링크","1235","1370","135","10.93","3734222","4802152665"
"039560","다산네트웍스","5670","5930","260","4.59","1077972","6248847330"
"058730","다스코","5500","5950","450","8.18","21168007","117043012995"
"298870","다올인베스트먼트","3180","3305","125","3.93","14640412","50942217330"
"030210","다올투자증권","4285","4455","170","3.97","2198461","9546263555"
"023590","다우기술","17800","18950","1150","6.46","704186","12956779100"
"032190","다우데이타","10250","11750","1500","14.63","1371479","14834142510"
"323350","다원넥스뷰","54000","47000","-7000","-12.96","1057","53901900"
"068240","다원시스","22550","23700","1150","5.10","3506549","79012430450"
"145210","다이나믹디자인","4735","4650","-85","-1.80","203708","944138490"
"271850","다이오진","1690","1690","0","0.00","0","0"
"019680","대교","2920","3050","130","4.45","1320329","4039852560"
"019685","대교우B","2175","2270","95","4.37","420135","993973270"
"006370","대구백화점","11250","10650","-600","-5.33","59458","638450400"
"008060","대덕","6220","6670","450","7.23","1251209","8189347190"
"00806K","대덕1우","9200","9290","90","0.98","34539","317940840"
"353200","대덕전자","28150","27400","-750","-2.66","15082187","432225225900"
"35320K","대덕전자1우","12300","12450","150","1.22","114415","1426229300"
"000490","대동","11450","12150","700","6.11","6913559","83448566900"
"178600","대동고려삼","4200","3840","-360","-8.57","25270","89541175"
"020400","대동금속","9060","10350","1290","14.24","2947320","30137492040"
"008830","대동기어","7200","8200","1000","13.89","17433483","151144047090"
"048470","대동스틸","4980","5700","720","14.46","9642127","56264633215"
"008110","대동전자","6450","13350","6900","106.98","51513039","568304443350"
"004780","대륙제관","4615","4835","220","4.77","7700769","38687869955"
"005750","대림B&Co","5000","6100","1100","22.00","5448841","32983399985"
"017650","대림제지","8640","8960","320","3.70","276241","2451086110"
"006570","대림통상","3895","3915","20","0.51","297086","1077620585"
"007720","대명소노시즌","852","901","49","5.75","3733358","3227804160"
"389260","대명에너지","14700","23950","9250","62.93","23094629","447936786100"
"317850","대모","8330","7980","-350","-4.20","6612798","53312858910"
"290670","대보마그네틱","41350","48350","7000","16.93","1163123","53355210250"
"078140","대봉엘에스","7420","8450","1030","13.88","16288227","152064252940"
"001680","대상","21400","23750","2350","10.98","2717438","60881645450"
"001685","대상우","16050","16900","850","5.30","96471","1577310300"
"084690","대상홀딩스","7990","8830","840","10.51","1026554","8524708500"
"084695","대상홀딩스우","10000","10350","350","3.50","306855","3157388490"
"036480","대성미생물","12300","13050","750","6.10","153890","1939810500"
"128820","대성산업","5110","5080","-30","-0.59","10563499","53323528835"
"117580","대성에너지","10750","13750","3000","27.91","30043148","378189994600"
"025440","대성엘텍","884","935","51","5.77","25415207","22759634216"
"027830","대성창투","3000","3470","470","15.67","152527178","652091791970"
"104040","대성파인텍","1625","1955","330","20.31","44230137","89523280640"
"016710","대성홀딩스","75500","85900","10400","13.77","2804560","228758650100"
"387310","대신밸런스제10호스팩","2265","2320","55","2.43","367728","834898060"
"397500","대신밸런스제11호스팩","2680","2680","0","0.00","0","0"
"020180","대신정보통신","1150","1385","235","20.43","41882103","57925188485"
"003540","대신증권","14900","15300","400","2.68","841551","12628004600"
"003547","대신증권2우B","13300","13700","400","3.01","267895","3571871350"
"003545","대신증권우","13550","14250","700","5.17","836566","11522986550"
"045390","대아티아이","3385","3710","325","9.60","23052876","84697698775"
"009190","대양금속","3560","3955","395","11.10","10209178","39308962325"
"108380","대양전기공업","12300","13400","1100","8.94","573296","7069262050"
"006580","대양제지","3260","3260","0","0.00","0","0"
"014160","대영포장","1650","1795","145","8.79","22493802","40584242860"
"047040","대우건설","5640","5470","-170","-3.01","42167371","223701560210"
"009320","대우부품","1810","2165","355","19.61","8196583","17899492470"
"042660","대우조선해양","20400","21550","1150","5.64","10760703","216364233250"
"003090","대웅","27250","27250","0","0.00","751286","21041475350"
"069620","대웅제약","179500","179500","0","0.00","1126047","206736024500"
"007680","대원","8840","8900","60","0.68","311867","2706080730"
"000430","대원강업","2825","3200","375","13.27","5218932","17760414340"
"048910","대원미디어","12350","14700","2350","19.03","2256598","31157351550"
"005710","대원산업","5280","5430","150","2.84","252636","1343364060"
"006340","대원전선","1500","1570","70","4.67","7396923","11219698515"
"006345","대원전선우","2630","2795","165","6.27","102176","268669250"
"003220","대원제약","17500","18150","650","3.71","9845289","182849492700"
"024890","대원화성","2450","3230","780","31.84","73528221","237615336300"
"290380","대유","4495","4640","145","3.23","16468522","79374775230"
"002880","대유에이텍","841","890","49","5.83","6318704","5420733465"
"290120","대유에이피","5470","6310","840","15.36","898192","5426240570"
"000300","대유플러스","869","945","76","8.75","9281796","8483432415"
"120240","대정화금","18100","18650","550","3.04","1080313","20039811350"
"003310","대주산업","3310","2655","-655","-19.79","35124912","102300742635"
"114920","대주이엔티","1820","2390","570","31.32","1535","2711950"
"078600","대주전자재료","65600","86700","21100","32.16","4332646","331584463500"
"012800","대창","1400","1545","145","10.36","7200530","10402589430"
"015230","대창단조","5240","5440","200","3.82","3899634","19895857395"
"096350","대창솔루션","433","423","-10","-2.31","19500120","8213327421"
"140520","대창스틸","3270","3475","205","6.27","1221212","4057934710"
"131220","대한과학","7400","10150","2750","37.16","25716841","264116571610"
"010170","대한광통신","2200","3215","1015","46.14","29969780","83956962105"
"060900","대한그린파워","735","873","138","18.78","71723838","59649622533"
"054670","대한뉴팜","10200","10800","600","5.88","1275104","13317585720"
"001070","대한방직","49700","52600","2900","5.84","471738","23054163700"
"023910","대한약품","26100","26800","700","2.68","97147","2618234200"
"006650","대한유화","128500","130500","2000","1.56","709430","88363983000"
"001440","대한전선","1825","1850","25","1.37","223442645","386235045480"
"084010","대한제강","15300","16500","1200","7.84","987389","15511742600"
"001790","대한제당","3300","3010","-290","-8.79","16851192","52946680965"
"001795","대한제당우","3215","2950","-265","-8.24","4566494","14258707600"
"001130","대한제분","145000","143500","-1500","-1.03","70713","9863166500"
"003490","대한항공","25150","25850","700","2.78","30881575","777097747900"
"003495","대한항공우","33350","32550","-800","-2.40","104671","3476199350"
"005880","대한해운","2440","2495","55","2.25","19319695","45762543775"
"003830","대한화섬","106000","110500","4500","4.25","11999","1256640000"
"016090","대현","2100","2245","145","6.90","3649177","7764740390"
"069460","대호에이엘","2500","2135","-365","-14.60","60788096","135366316675"
"021040","대호특수강","632","740","108","17.09","1855527","1284748941"
"021045","대호특수강우","1320","1320","0","0.00","177731","237663400"
"067080","대화제약","7150","8110","960","13.43","841356","6376576970"
"298540","더네이쳐홀딩스","29600","28800","-800","-2.70","584546","17282673700"
"192080","더블유게임즈","40900","39650","-1250","-3.06","1184989","48223080800"
"299170","더블유에스아이","2040","2380","340","16.67","1224901","2706876325"
"012510","더존비즈온","36100","33100","-3000","-8.31","2351602","78913655000"
"302920","더콘텐츠온","9990","9990","0","0.00","72","684530"
"213420","덕산네오룩스","31200","31750","550","1.76","1980739","62689068500"
"317330","덕산테코피아","15650","16000","350","2.24","1067872","16778285350"
"077360","덕산하이메탈","7280","7090","-190","-2.61","5368650","40197493240"
"004830","덕성","6260","6220","-40","-0.64","2406086","15127060270"
"004835","덕성우","7260","7260","0","0.00","245123","1801871690"
"090410","덕신하우징","2240","2500","260","11.61","39951883","93245701615"
"024900","덕양산업","2480","2780","300","12.10","1432830","3813187120"
"263600","덕우전자","6270","7310","1040","16.59","11171945","82384204140"
"194480","데브시스터즈","45000","45600","600","1.33","3090245","149234020250"
"348840","데이드림엔터","10950","10500","-450","-4.11","0","0"
"263800","데이타솔루션","5490","5640","150","2.73","4505906","25052804370"
"199150","데이터스트림즈","11450","10250","-1200","-10.48","6231","62688350"
"206560","덱스터","14150","16450","2300","16.25","17532766","280454547600"
"261200","덴티스","8840","9990","1150","13.01","2152735","20441244690"
"145720","덴티움","84200","100500","16300","19.36","3378766","291729068200"
"227420","도부마스크","4080","3700","-380","-9.31","152443","570929880"
"067990","도이치모터스","8380","8230","-150","-1.79","7153126","59480968200"
"002150","도화엔지니어링","9450","9230","-220","-2.33","10157101","93543563680"
"006620","동구바이오제약","6520","6840","320","4.91","2025437","13741315430"
"100130","동국S&C","5530","7080","1550","28.03","58619588","396381547360"
"005160","동국산업","2855","3065","210","7.36","1156490","3381753780"
"075970","동국알앤에스","3790","4200","410","10.82","17252593","72900961325"
"001230","동국제강","12750","14050","1300","10.20","9159229","117741382900"
"086450","동국제약","19850","19750","-100","-0.50","1224877","23774717600"
"023450","동남합성","58400","59000","600","1.03","18820","1096216400"
"004140","동방","2780","2970","190","6.83","4971876","14528405360"
"099410","동방선기","3125","3445","320","10.24","2284745","7435985950"
"007590","동방아그로","6900","7250","350","5.07","266779","1873829550"
"005960","동부건설","10850","11800","950","8.76","799146","8644019250"
"005965","동부건설우","25700","28500","2800","10.89","8760","225298950"
"026960","동서","25700","25350","-350","-1.36","1074572","26865946750"
"002210","동성제약","7860","8060","200","2.54","654682","5172274790"
"102260","동성케미컬","4000","4470","470","11.75","626218","2658857560"
"033500","동성화인텍","10750","12500","1750","16.28","7383774","85952344550"
"025950","동신건설","20250","22550","2300","11.36","2673851","58476185950"
"000640","동아쏘시오홀딩스","102500","108500","6000","5.85","166229","17305905500"
"170900","동아에스티","58900","59600","700","1.19","113096","6903418200"
"088130","동아엘텍","7020","7410","390","5.56","196192","1410201810"
"028100","동아지질","16650","18550","1900","11.41","1040286","18433785100"
"282690","동아타이어","11600","12050","450","3.88","150735","1762338100"
"041930","동아화성","8060","9270","1210","15.01","2675015","23466673240"
"001520","동양","1150","1190","40","3.48","6658644","7809960915"
"001527","동양2우B","12400","13050","650","5.24","27131","343917250"
"084670","동양고속","15700","16600","900","5.73","16822","264728000"
"082640","동양생명","5600","5510","-90","-1.61","1565505","8501186410"
"060380","동양에스텍","2435","2760","325","13.35","13174391","36661440625"
"001525","동양우","6300","6340","40","0.63","51081","322064030"
"079960","동양이엔피","13600","14900","1300","9.56","459191","6580784550"
"008970","동양철관","1085","1165","80","7.37","34010795","38039797410"
"228340","동양파일","3625","3935","310","8.55","779126","2872132750"
"092780","동양피스톤","4880","5240","360","7.38","989437","4980675770"
"088910","동우팜투테이블","2765","2900","135","4.88","2351742","6530154190"
"094170","동운아나텍","8490","8390","-100","-1.18","9434237","81909180050"
"049770","동원F&B","153500","164500","11000","7.17","62683","9866494000"
"013120","동원개발","4200","4205","5","0.12","2102416","8738533000"
"018500","동원금속","864","904","40","4.63","1782095","1582455294"
"006040","동원산업","214000","229500","15500","7.24","57380","12824015000"
"030720","동원수산","9250","10100","850","9.19","1795673","17814223110"
"014820","동원시스템즈","51900","57700","5800","11.18","640626","35367639350"
"014825","동원시스템즈우","31750","34150","2400","7.56","2681","87377700"
"163560","동일고무벨트","7930","7140","-790","-9.96","1990736","14524714610"
"109860","동일금속","18200","20150","1950","10.71","1213035","22876171400"
"032960","동일기연","11700","13300","1600","13.68","5039878","70964310000"
"004890","동일산업","169000","180000","11000","6.51","93190","16276826500"
"002690","동일제강","3245","3390","145","4.47","2523030","8145213790"
"023790","동일철강","2705","2790","85","3.14","687742","1850274920"
"005290","동진쎄미켐","33450","34450","1000","2.99","15844212","556571893200"
"025900","동화기업","60900","73600","12700","20.85","1120604","73421622000"
"000020","동화약품","10500","10600","100","0.95","3301449","35874652200"
"000150","두산","68100","80100","12000","17.62","1644012","116512810600"
"000157","두산2우B","93500","102000","8500","9.09","32999","3163942400"
"241560","두산밥캣","29100","32450","3350","11.51","6480036","199565217750"
"034020","두산에너빌리티","18550","20300","1750","9.43","79129110","1465798584500"
"000155","두산우","45600","52200","6600","14.47","55487","2633158400"
"131970","두산테스나","30750","29300","-1450","-4.72","2946843","87279181500"
"336260","두산퓨얼셀","30000","38850","8850","29.50","8359987","272414114300"
"33626K","두산퓨얼셀1우","9460","13050","3590","37.95","851270","10145729370"
"33626L","두산퓨얼셀2우B","12450","15750","3300","26.51","539640","7949865250"
"016740","두올","2760","2960","200","7.25","2450659","7114163685"
"073190","듀오백","2215","2780","565","25.51","1069611","2755118355"
"176750","듀켐바이오","7030","6700","-330","-4.69","136105","914238250"
"030350","드래곤플라이","1885","2075","190","10.08","29668866","61250119490"
"203650","드림시큐리티","3110","3370","260","8.36","11671346","39372669925"
"223250","드림씨아이에스","14050","14300","250","1.78","751440","10603430600"
"060570","드림어스컴퍼니","3300","3705","405","12.27","1026314","3552655665"
"192650","드림텍","9570","9270","-300","-3.13","3611494","33560768890"
"217620","디딤","1375","1400","25","1.82","8852401","13028014527"
"016670","디모아","973","973","0","0.00","0","0"
"187870","디바이스이엔지","17200","18600","1400","8.14","218137","3950651000"
"066670","디스플레이텍","5950","6200","250","4.20","6389165","40648684350"
"024090","디씨엠","22350","20500","-1850","-8.28","1068846","22771829400"
"003160","디아이","5910","6190","280","4.74","1593145","10003861230"
"092200","디아이씨","4125","4490","365","8.85","2532503","10933276380"
"110990","디아이티","7170","7100","-70","-0.98","1599801","11959366420"
"078590","디아크","2380","2380","0","0.00","0","0"
"263690","디알젬","8710","9640","930","10.68","176455","1648402750"
"214680","디알텍","1525","1645","120","7.87","9174945","14189925170"
"377190","디앤디플랫폼리츠","4410","4650","240","5.44","2761150","11901802280"
"263720","디앤씨미디어","21700","23000","1300","5.99","956112","22090969450"
"376300","디어유","34750","37500","2750","7.91","3718312","140458620400"
"141020","디에스앤엘","1335","1335","0","0.00","0","0"
"109740","디에스케이","5190","5770","580","11.18","344052","1906183960"
"196490","디에이테크놀로지","3930","4715","785","19.97","4512406","19105258440"
"066900","디에이피","3310","3505","195","5.89","865513","2982804860"
"180400","디엑스앤브이엑스","7740","7740","0","0.00","0","0"
"127120","디엔에이링크","3975","3930","-45","-1.13","1541321","5934732405"
"092070","디엔에프","14550","14000","-550","-3.78","1073508","15811568750"
"039840","디오","26700","27600","900","3.37","1038447","28188664800"
"013570","디와이","6850","7350","500","7.30","6520655","46344391490"
"219550","디와이디","1435","1540","105","7.32","25544446","39167944395"
"310870","디와이씨","1450","1590","140","9.66","3861060","5961669260"
"210540","디와이파워","12650","12600","-50","-0.40","1317683","15627161100"
"104460","디와이피엔에프","38500","40450","1950","5.06","477105","18242001150"
"079810","디이엔티","6780","7950","1170","17.26","1359910","10169322840"
"113810","디젠스","1100","1255","155","14.09","34724593","44974006054"
"043360","디지아이","3600","3450","-150","-4.17","1401492","4982077755"
"197140","디지캡","4045","4140","95","2.35","1245077","4962803130"
"068930","디지털대성","6940","7920","980","14.12","894174","6455801950"
"033130","디지틀조선","2180","2320","140","6.42","1971562","4457168035"
"105740","디케이락","9440","11900","2460","26.06","1438221","15197342600"
"263020","디케이앤디","2955","3175","220","7.45","1022782","3154116630"
"290550","디케이티","9240","11000","1760","19.05","1740741","18315561600"
"187220","디티앤씨","5040","5620","580","11.51","2358501","13121484810"
"163430","디피코","7620","7620","0","0.00","0","0"
"131180","딜리","1660","1670","10","0.60","1358725","2233517565"
"315640","딥노이드","8180","8670","490","5.99","1263144","11179465710"
"317120","라닉스","6200","6760","560","9.03","1454334","9670142990"
"042510","라온시큐어","2745","3050","305","11.11","11325996","33671571400"
"232680","라온테크","14700","14650","-50","-0.34","2557005","37688339300"
"300120","라온피플","7132","5810","-1322","-18.54","6997244","65778731590"
"171120","라이온켐텍","7600","8960","1360","17.89","11297696","105124188840"
"069540","라이트론","3880","4260","380","9.79","1657886","6546353860"
"285770","라이프사이언스테크놀로지","1390","1390","0","0.00","0","0"
"347700","라이프시맨틱스","5700","5960","260","4.56","2178249","13211720200"
"214260","라파스","38600","40550","1950","5.05","613342","24824299100"
"403360","라피치","13000","13500","500","3.85","1488","18975600"
"115390","락앤락","7810","8080","270","3.46","4569871","39924116460"
"200350","래몽래인","16100","21750","5650","35.09","4547596","89218704500"
"171010","램테크놀러지","6190","7450","1260","20.36","5715256","40645618610"
"084650","랩지노믹스","7590","8130","540","7.11","93314797","824532037070"
"217500","러셀","3490","3825","335","9.60","10677922","40830616445"
"092590","럭스피아","2350","2085","-265","-11.28","25943","48196140"
"141080","레고켐바이오","47950","50000","2050","4.28","5247282","245169970250"
"060300","레드로버","1830","1830","0","0.00","0","0"
"038390","레드캡투어","18350","20350","2000","10.90","434325","8849579800"
"294140","레몬","5920","5440","-480","-8.11","12066599","68681019080"
"228670","레이","23950","23300","-650","-2.71","2944609","71026682550"
"228850","레이언스","9500","10750","1250","13.16","960492","10044422190"
"412350","레이저쎌","14750","12250","-2500","-16.95","11639115","150074286290"
"281740","레이크머티리얼즈","4450","4720","270","6.07","9301115","44884429675"
"277810","레인보우로보틱스","23750","28200","4450","18.74","10596598","295605647200"
"179720","렌딩머신","5600","5100","-500","-8.93","165","967400"
"215100","로보로보","7300","7750","450","6.16","19353095","150129244580"
"090360","로보스타","18500","20700","2200","11.89","2214505","44138211950"
"238500","로보쓰리","798","740","-58","-7.27","949105","671704106"
"108490","로보티즈","18150","21750","3600","19.83","8740623","186749903700"
"900260","로스웰","307","358","51","16.61","212065715","78433266887"
"223220","로지스몬","598","590","-8","-1.34","3159","1509486"
"067730","로지시스","4950","5850","900","18.18","6693008","40634139010"
"071280","로체시스템즈","6020","6390","370","6.15","2323231","14530846590"
"032350","롯데관광개발","11900","11700","-200","-1.68","8610784","97922220400"
"089860","롯데렌탈","36650","38150","1500","4.09","1519536","58414053100"
"330590","롯데리츠","5290","5070","-220","-4.16","5497653","27792841823"
"000400","롯데손해보험","1615","1700","85","5.26","3672644","6142625875"
"023530","롯데쇼핑","99000","102000","3000","3.03","2141770","202207895400"
"004000","롯데정밀화학","68800","68400","-400","-0.58","3400832","223626007500"
"286940","롯데정보통신","26350","27550","1200","4.55","551367","14876548650"
"280360","롯데제과","115500","123500","8000","6.93","247799","29277289500"
"004990","롯데지주","35050","39000","3950","11.27","3785040","135639512950"
"00499K","롯데지주우","47600","50700","3100","6.51","20902","1014178100"
"005300","롯데칠성","174000","165500","-8500","-4.89","893324","151759175500"
"005305","롯데칠성우","71900","71400","-500","-0.70","25640","1823794500"
"011170","롯데케미칼","180000","183000","3000","1.67","2370676","411463241500"
"071840","롯데하이마트","16850","16700","-150","-0.89","411283","6940971300"
"038060","루멘스","1135","1190","55","4.85","3334359","3896151890"
"162120","루켄테크놀러지스","4800","5100","300","6.25","42518","203993190"
"253610","루트락","2395","2290","-105","-4.38","20701","42295815"
"085370","루트로닉","17900","20750","2850","15.92","7331037","140300163750"
"08537M","루트로닉3우C","25200","28850","3650","14.48","4168","107938600"
"060240","룽투코리아","4765","5290","525","11.02","32330008","173607864065"
"058470","리노공업","134200","132600","-1600","-1.19","1014693","133107474664"
"039980","리노스","1030","974","-56","-5.44","7480198","7111118052"
"019570","리더스 기술투자","400","388","-12","-3.00","12884476","5100280475"
"016100","리더스코스메틱","2820","2635","-185","-6.56","346374","933115310"
"012700","리드코프","8080","8430","350","4.33","2698904","22419436200"
"302550","리메드","13400","13550","150","1.12","457607","6388948100"
"377450","리파인","11500","11050","-450","-3.91","855093","9477643850"
"277070","린드먼아시아","4720","5060","340","7.20","4351936","22640657535"
"042500","링네트","4550","5020","470","10.33","5080825","27517054975"
"219420","링크제니시스","5680","7000","1320","23.24","9643781","68431619270"
"027740","마니커","1585","1415","-170","-10.73","10176807","14585221490"
"195500","마니커에프앤지","3915","4115","200","5.11","4039393","16581874460"
"357430","마스턴프리미어리츠","5010","5020","10","0.20","336182","1664279550"
"222810","마이더스AI","2070","1565","-505","-24.40","58916396","118518991390"
"305090","마이크로디지탈","5140","5320","180","3.50","1653574","9497342730"
"098120","마이크로컨텍솔","6300","6430","130","2.06","1261710","8131029450"
"147760","마이크로프랜드","4550","4940","390","8.57","396252","1935442525"
"377480","마인즈랩","16250","16800","550","3.38","1444896","24359414850"
"038290","마크로젠","26200","26950","750","2.86","317661","8334408750"
"204320","만도","48500","55700","7200","14.85","7258337","392924728600"
"001080","만호제강","22300","27550","5250","23.54","198391","4818482700"
"267980","매일유업","59100","59100","0","0.00","230062","13470890500"
"005990","매일홀딩스","9230","8920","-310","-3.36","102341","918442840"
"127160","매직마이크로","282","282","0","0.00","0","0"
"093520","매커스","7940","9040","1100","13.85","3220434","28320590460"
"377030","맥스트","17850","18850","1000","5.60","11704635","218344759350"
"088980","맥쿼리인프라","12200","12900","700","5.74","20345987","252762306800"
"094800","맵스리얼티1","4520","4510","-10","-0.22","796631","3535061830"
"100590","머큐리","6430","6660","230","3.58","379791","2492458100"
"067280","멀티캠퍼스","38100","40100","2000","5.25","161510","6537345800"
"072870","메가스터디","11200","11250","50","0.45","1499247","17348559200"
"215200","메가스터디교육","77400","84900","7500","9.69","1477944","126879428800"
"133750","메가엠디","2670","3135","465","17.42","57506455","210455321370"
"235980","메드팩토","26400","32500","6100","23.11","5294453","160466179600"
"200580","메디쎄이","14000","16450","2450","17.50","82729","1189680300"
"041920","메디아나","5100","5070","-30","-0.59","12369284","68722090315"
"233250","메디안디노스틱","32600","32700","100","0.31","267","8364050"
"014100","메디앙스","4160","4085","-75","-1.80","561506","2266702940"
"236340","메디젠휴먼케어","9400","9080","-320","-3.40","4828","43737760"
"054180","메디콕스","5410","8250","2840","52.50","16400517","124463158030"
"086900","메디톡스","113800","110000","-3800","-3.34","477445","54078250700"
"078160","메디포스트","19450","21300","1850","9.51","3566501","76594112300"
"065650","메디프론","1595","1740","145","9.09","2094327","3555539825"
"138040","메리츠금융지주","26600","29050","2450","9.21","2999028","78211921950"
"008560","메리츠증권","4665","4865","200","4.29","16065143","74353636460"
"000060","메리츠화재","32550","36950","4400","13.52","3579850","120432815600"
"021880","메이슨캐피탈","566","476","-90","-15.90","28360136","14269817440"
"140410","메지온","19600","18650","-950","-4.85","10103712","212718585250"
"241770","메카로","10550","11450","900","8.53","193905","2096718510"
"090370","메타랩스","871","731","-140","-16.07","9090490","6982274641"
"059210","메타바이오메드","2270","2440","170","7.49","2208860","5280198520"
"058110","멕아이씨에스","6090","6400","310","5.09","29566259","211538246480"
"096640","멜파스","1495","1495","0","0.00","0","0"
"017180","명문제약","3270","3485","215","6.57","1291764","4334910270"
"257370","명성티엔에스","9210","9210","0","0.00","0","0"
"009900","명신산업","16650","22150","5500","33.03","11831300","238531861250"
"267060","명진홀딩스","181","181","0","0.00","0","0"
"012690","모나리자","3495","3480","-15","-0.43","6968912","24159182235"
"005360","모나미","4165","3800","-365","-8.76","12790133","47999061785"
"080420","모다이노칩","3405","3395","-10","-0.29","5211660","17630296270"
"080160","모두투어","15650","16200","550","3.51","1615818","24486803750"
"204210","모두투어리츠","4560","4830","270","5.92","89508","421274035"
"100030","모바일리더","20750","21300","550","2.65","197418","4079434000"
"087260","모바일어플라이언스","3165","3435","270","8.53","21123677","73350769590"
"101330","모베이스","2920","3185","265","9.08","2224704","6888635500"
"012860","모베이스전자","1395","1510","115","8.24","24135569","36439729110"
"363260","모비데이즈","1515","1490","-25","-1.65","20615484","32756539740"
"348030","모비릭스","15100","18150","3050","20.20","22763438","420874668700"
"250060","모비스","1740","2445","705","40.52","44952180","110603645005"
"288980","모아데이타","3843","2375","-1468","-38.20","64520433","411504168750"
"033200","모아텍","5610","9490","3880","69.16","26925995","247592335330"
"009680","모토닉","8480","8530","50","0.59","240989","2066870220"
"118990","모트렉스","10850","12000","1150","10.60","27714556","329043516740"
"006920","모헨즈","3960","4550","590","14.90","5163355","23026203075"
"009580","무림P&P","3970","4700","730","18.39","6936547","30228405940"
"001810","무림SP","2690","3000","310","11.52","11827857","35903717700"
"009200","무림페이퍼","2590","2745","155","5.98","21857961","61939252480"
"135160","무송지오씨","2660","2550","-110","-4.14","136642","346276525"
"322970","무진메디","5010","4995","-15","-0.30","54987","271796755"
"033920","무학","6680","7070","390","5.84","2345198","16505758140"
"008420","문배철강","3620","3895","275","7.60","3738021","14223767865"
"279600","미디어젠","10450","9830","-620","-5.93","172115","1713792080"
"095500","미래나노텍","6030","9290","3260","54.06","80193326","674286168650"
"025560","미래산업","10100","11300","1200","11.88","578829","6306565750"
"218150","미래생명자원","6500","5930","-570","-8.77","16793601","105885542490"
"007120","미래아이앤지","314","347","33","10.51","46993741","17187505098"
"396690","미래에셋글로벌리츠","4775","4885","110","2.30","993018","4680259085"
"353490","미래에셋대우스팩 5호","2150","2135","-15","-0.70","2888713","6548739000"
"328380","미래에셋대우스팩3호","2130","2265","135","6.34","19780501","48154533460"
"357250","미래에셋맵스리츠","4275","4405","130","3.04","668131","2843874590"
"100790","미래에셋벤처투자","5650","6160","510","9.03","2159005","12896269220"
"412930","미래에셋비전스팩1호","2150","2115","-35","-1.63","728597","1553555705"
"085620","미래에셋생명","3115","3145","30","0.96","1098745","3357746700"
"006800","미래에셋증권","6470","6670","200","3.09","22385076","143011651380"
"00680K","미래에셋증권2우B","3785","3930","145","3.83","2341213","8963151585"
"006805","미래에셋증권우","4350","4890","540","12.41","186062","842794955"
"208890","미래엔에듀파트너","1485","1300","-185","-12.46","1315","1618195"
"049950","미래컴퍼니","19550","21700","2150","11.00","471450","9728026550"
"207760","미스터블루","5440","6290","850","15.63","4434054","27976115490"
"002840","미원상사","175000","179000","4000","2.29","30339","5424950500"
"268280","미원에스씨","198000","192500","-5500","-2.78","30474","5905479000"
"107590","미원홀딩스","132500","136500","4000","3.02","10679","1418537500"
"134380","미원화학","66100","66900","800","1.21","5921","391398200"
"003650","미창석유","81600","82700","1100","1.35","9711","780507100"
"059090","미코","8190","9140","950","11.60","1719219","14950865750"
"214610","미코바이오메드","12200","11150","-1050","-8.61","76929557","1024177382100"
"201490","미투온","4425","4860","435","9.83","4209695","20136338720"
"950190","미투젠","16300","15900","-400","-2.45","839581","14124588550"
"155900","바다로19호","3340","3335","-5","-0.15","451335","1509532475"
"206640","바디텍메드","12950","12350","-600","-4.63","6069411","84781365400"
"018700","바른손","2695","3045","350","12.99","27383111","83073619555"
"035620","바른손이앤에이","1055","1160","105","9.95","7301654","8232852050"
"064520","바른전자","7000","5680","-1320","-18.86","1564171","8774944900"
"053030","바이넥스","15100","15350","250","1.66","6632209","100596460700"
"301300","바이브컴퍼니","30500","32600","2100","6.89","475849","14919630900"
"064550","바이오니아","34150","33500","-650","-1.90","44161648","1656428044750"
"314930","바이오다인","27200","27850","650","2.39","232355","6537095100"
"208710","바이오로그디바이스","1430","1320","-110","-7.69","23369331","33792179200"
"086820","바이오솔루션","15050","15100","50","0.33","749348","11568578500"
"038460","바이오스마트","4000","4380","380","9.50","12557425","58572043720"
"281310","바이오시네틱스","7600","7600","0","0.00","0","0"
"251120","바이오에프디엔씨","24200","23250","-950","-3.93","1236968","28030408800"
"266470","바이오인프라생명과학","2110","1695","-415","-19.67","233176","419548440"
"086040","바이오톡스텍","7660","8390","730","9.53","16390882","145032361910"
"199290","바이오프로테크","1085","1060","-25","-2.30","5325","5150761"
"099430","바이오플러스","30500","31750","1250","4.10","13888617","439079845693"
"032980","바이온","1350","1205","-145","-10.74","3231593","3765598190"
"222160","바이옵트로","6520","6650","130","1.99","1980916","13380973400"
"308080","바이젠셀","9310","9530","220","2.36","5212387","50978166590"
"043150","바텍","30350","35300","4950","16.31","1022015","33712477600"
"323990","박셀바이오","40400","65300","24900","61.63","36353793","2206733883350"
"003610","방림","2925","3755","830","28.38","5398422","17597730920"
"267790","배럴","7940","7840","-100","-1.26","912565","7281986190"
"001340","백광산업","4290","4745","455","10.61","20374328","91417018495"
"046310","백금T&A","2830","2995","165","5.83","1488149","4210735160"
"035150","백산","9310","10150","840","9.02","6303919","62475643330"
"066410","버킷스튜디오","2005","3210","1205","60.10","608352687","1703612843475"
"002410","범양건영","4650","5420","770","16.56","33305734","172587414015"
"382900","범한퓨얼셀","33900","33500","-400","-1.18","7867467","246844922950"
"206400","베노홀딩스","3405","3450","45","1.32","1815499","6381073055"
"019010","베뉴지","2295","2245","-50","-2.18","9068929","20256250670"
"322190","베른","553","664","111","20.07","65822","36941956"
"177350","베셀","6790","7970","1180","17.38","21120891","158678205800"
"299910","베스파","3165","3165","0","0.00","0","0"
"096300","베트남개발1","205","209","4","1.95","1242929","256221804"
"007210","벽산","2735","2950","215","7.86","12001143","34074196475"
"225530","보광산업","6610","7040","430","6.51","19026846","132143428890"
"250000","보라티알","12000","12900","900","7.50","2808416","36675464050"
"002760","보락","1695","1775","80","4.72","3755577","6559582500"
"003850","보령","10350","11150","800","7.73","2854355","31077235350"
"310210","보로노이","48000","41550","-6450","-13.44","9781151","417197864950"
"006910","보성파워텍","5550","5630","80","1.44","32358696","174104721180"
"000890","보해양조","726","770","44","6.06","6361491","4758854166"
"226340","본느","1680","1745","65","3.87","2403596","4187347485"
"206950","볼빅","2950","3200","250","8.47","5849","18506740"
"003000","부광약품","8670","9740","1070","12.34","40257198","390704911590"
"001270","부국증권","21250","22600","1350","6.35","23332","496863600"
"001275","부국증권우","20200","20200","0","0.00","20624","412777950"
"026940","부국철강","3610","3990","380","10.53","2449685","9234757850"
"014470","부방","2250","2320","70","3.11","3135169","7153559120"
"011390","부산산업","86600","88800","2200","2.54","88461","7706613400"
"005030","부산주공","890","816","-74","-8.31","65599304","55036727733"
"008470","부스타","5200","5420","220","4.23","262384","1373297400"
"338220","뷰노","8120","7760","-360","-4.43","2137537","16649439690"
"100120","뷰웍스","34650","43200","8550","24.68","853585","34377558650"
"337930","브랜드엑스코퍼레이션","7280","8160","880","12.09","2064020","16325972350"
"099390","브레인즈컴퍼니","8520","8820","300","3.52","735610","6646920710"
"064480","브리지텍","4845","5500","655","13.52","1556752","8012051470"
"288330","브릿지바이오테라퓨틱스","9080","12700","3620","39.87","3331084","39593718440"
"365900","브이씨","12600","10550","-2050","-16.27","2988836","34964869150"
"251630","브이원텍","7400","7840","440","5.95","882428","6819894540"
"018290","브이티지엠피","5270","5460","190","3.61","3406686","18623333920"
"044480","블루베리 NFT","2455","2195","-260","-10.59","17649938","42896629190"
"033560","블루콤","9880","9720","-160","-1.62","374190","3644619140"
"191600","블루탑","6930","9670","2740","39.54","1003","7706250"
"369370","블리츠웨이","2810","3090","280","9.96","5758220","16965691805"
"126340","비나텍","41450","45500","4050","9.77","615246","25532134700"
"121800","비덴트","8920","10700","1780","19.96","166328903","1948999857690"
"148140","비디아이","640","640","0","0.00","0","0"
"082800","비보존 헬스케어","959","1005","46","4.80","8376737","8403499337"
"318410","비비씨","10700","11200","500","4.67","562310","6324855150"
"002070","비비안","1730","1935","205","11.85","11987786","23659795655"
"100220","비상교육","6120","6560","440","7.19","1869328","12483951130"
"146320","비씨엔씨","17000","17050","50","0.29","1642710","28189100850"
"200780","비씨월드제약","10200","10950","750","7.35","1345952","15272274100"
"141000","비아트론","8320","9050","730","8.77","783086","6944416720"
"090460","비에이치","25500","28300","2800","10.98","16680537","455069364250"
"083650","비에이치아이","7600","8320","720","9.47","22632140","167010417550"
"215050","비엔디생활건강","912","912","0","0.00","0","0"
"142760","비엘","6110","6290","180","2.95","26485604","197036348990"
"065170","비엘팜텍","936","918","-18","-1.92","3913743","3705292927"
"086220","비엘헬스케어","2585","2750","165","6.38","852","2246560"
"086670","비엠티","12050","16000","3950","32.78","4129137","60768667350"
"335890","비올","2000","2075","75","3.75","4749764","9787036680"
"138580","비즈니스온","8060","8340","280","3.47","653531","5347957170"
"082920","비츠로셀","11150","13600","2450","21.97","1662010","20562718200"
"054220","비츠로시스","5640","2350","-3290","-58.33","41004722","120018602775"
"042370","비츠로테크","7050","7130","80","1.13","1501207","10564110600"
"030790","비케이탑스","904","904","0","0.00","0","0"
"050090","비케이홀딩스","520","571","51","9.81","20660160","11986386317"
"307870","비투엔","2050","2270","220","10.73","33413415","91889581265"
"357880","비트나인","12000","11250","-750","-6.25","4295164","49878029950"
"032850","비트컴퓨터","6620","7260","640","9.67","7005953","51760517650"
"148780","비플라이소프트","2140","2175","35","1.64","28905093","216092856250"
"238200","비피도","8380","8370","-10","-0.12","393681","3223586210"
"093190","빅솔론","6100","6930","830","13.61","1193057","8117295070"
"065450","빅텍","5340","6040","700","13.11","23722792","138755347995"
"210120","빅텐츠","18950","20400","1450","7.65","1577","29115900"
"005180","빙그레","46650","47150","500","1.07","158785","7504457450"
"072950","빛샘전자","6550","7190","640","9.77","581390","4059137950"
"266170","뿌리깊은나무들","1430","1080","-350","-24.48","141577","135893991"
"143240","사람인에이치알","33100","34000","900","2.72","727295","23942215250"
"003960","사조대림","24600","26300","1700","6.91","392035","9629739050"
"008040","사조동아원","1600","1360","-240","-15.00","59205504","85260350060"
"007160","사조산업","45200","45400","200","0.44","169791","7581222900"
"014710","사조씨푸드","5160","5800","640","12.40","20264527","120185400725"
"006090","사조오양","9120","9300","180","1.97","348241","3159812140"
"100090","삼강엠앤티","19450","26850","7400","38.05","14943937","347289350650"
"122350","삼기","3120","3500","380","12.18","4075935","13992211950"
"014970","삼륭물산","5960","6800","840","14.09","8615359","57230197710"
"018310","삼목에스폼","18700","21650","2950","15.78","1049422","20950886150"
"053700","삼보모터스","4000","4800","800","20.00","6220139","31472592970"
"009620","삼보산업","1105","1275","170","15.38","11616965","14146924395"
"023600","삼보판지","9540","10100","560","5.87","597888","5861663860"
"001470","삼부토건","2160","2175","15","0.69","102075565","213920649325"
"006400","삼성SDI","537000","616000","79000","14.71","5448989","3100642537765"
"006405","삼성SDI우","274000","310000","36000","13.14","45863","13443760000"
"006660","삼성공조","10600","10600","0","0.00","205700","2168475900"
"380320","삼성머스트스팩5호","4490","4990","500","11.14","30846980","150832467120"
"028260","삼성물산","114000","123000","9000","7.89","5380004","632462566500"
"02826K","삼성물산우B","103500","112500","9000","8.70","65259","7123782000"
"207940","삼성바이오로직스","819000","902000","83000","10.13","1248927","1063062139300"
"032830","삼성생명","60200","62300","2100","3.49","4043606","240908251970"
"377630","삼성스팩4호","6020","8420","2400","39.87","81780602","628582287970"
"425290","삼성스팩6호","7560","6550","-1010","-13.36","46591978","319773204070"
"018260","삼성에스디에스","132500","131500","-1000","-0.75","2454904","325126288500"
"028050","삼성엔지니어링","20550","21800","1250","6.08","24801533","488684800600"
"009150","삼성전기","134500","134000","-500","-0.37","10946799","1520627386654"
"009155","삼성전기우","74800","76800","2000","2.67","104009","8107835700"
"005930","삼성전자","58700","59900","1200","2.04","298873174","18073265602226"
"005935","삼성전자우","53900","54600","700","1.30","18839304","1045760142661"
"001360","삼성제약","3330","3880","550","16.52","18344731","72775019370"
"010140","삼성중공업","5500","5950","450","8.18","74723112","417523471170"
"010145","삼성중공우","229500","231000","1500","0.65","8909","2017204000"
"016360","삼성증권","33650","35350","1700","5.05","5804623","193502945550"
"068290","삼성출판사","25550","27800","2250","8.81","1533975","41291918850"
"029780","삼성카드","30500","31750","1250","4.10","1545267","48049459568"
"000810","삼성화재","196500","203500","7000","3.56","1566878","311594453725"
"000815","삼성화재우","156000","159000","3000","1.92","114458","17994071500"
"006110","삼아알미늄","16900","23250","6350","37.57","5241927","111911050200"
"009300","삼아제약","14750","15400","650","4.41","230626","3527151450"
"145990","삼양사","41350","42600","1250","3.02","218658","9066728100"
"145995","삼양사우","32800","34900","2100","6.40","3647","124906100"
"003230","삼양식품","102500","111000","8500","8.29","1613864","172566586500"
"225190","삼양옵틱스","12650","12300","-350","-2.77","446323","5418694600"
"002170","삼양통상","53400","53300","-100","-0.19","27339","1445117600"
"272550","삼양패키징","17150","19800","2650","15.45","176541","3325595750"
"000070","삼양홀딩스","73500","74500","1000","1.36","300778","22032377900"
"000075","삼양홀딩스우","60000","59600","-400","-0.67","709","42352900"
"002810","삼영무역","13350","13600","250","1.87","99997","1351705850"
"361670","삼영에스앤씨","7000","7560","560","8.00","283051","2120360160"
"054540","삼영엠텍","5450","5790","340","6.24","43017911","231750555525"
"065570","삼영이엔씨","4890","7380","2490","50.92","17639128","109827803420"
"005680","삼영전자","10350","10500","150","1.45","563932","5860021000"
"003720","삼영화학","2475","3280","805","32.53","37213223","114751927455"
"023000","삼원강재","2580","2820","240","9.30","642411","1803667690"
"004380","삼익THK","12150","13800","1650","13.58","2340480","31847854850"
"002450","삼익악기","1410","1545","135","9.57","6502265","10304218300"
"032280","삼일","2155","2420","265","12.30","2571229","5872589060"
"002290","삼일기업공사","3720","4630","910","24.46","16653102","77951566460"
"004440","삼일씨엔에스","7540","9240","1700","22.55","969036","8971453640"
"000520","삼일제약","7800","8100","300","3.85","2999246","24712063230"
"009770","삼정펄프","26250","30050","3800","14.48","1259480","36780649800"
"037460","삼지전자","9830","10300","470","4.78","506763","5161376030"
"032750","삼진","6750","7380","630","9.33","3476085","27777955180"
"054090","삼진엘앤디","3400","3465","65","1.91","70859115","243677416985"
"005500","삼진제약","24550","24500","-50","-0.20","2324149","58230930550"
"000250","삼천당제약","32650","36900","4250","13.02","3302273","116713302700"
"004690","삼천리","182000","194000","12000","6.59","603601","112064972000"
"024950","삼천리자전거","7680","7920","240","3.13","2226253","17213119450"
"038500","삼표시멘트","4050","4440","390","9.63","8650281","38248994750"
"017480","삼현철강","5500","5870","370","6.73","781322","4308282470"
"010960","삼호개발","3980","4300","320","8.04","955693","3936487000"
"046390","삼화네트웍스","3630","3825","195","5.37","18628673","69205119635"
"004450","삼화왕관","37050","42450","5400","14.57","994561","44078044100"
"009470","삼화전기","18250","19150","900","4.93","192808","3583141300"
"011230","삼화전자","2965","3050","85","2.87","407833","1240085755"
"001820","삼화콘덴서","39700","42550","2850","7.18","545342","23036070450"
"000390","삼화페인트","6690","8300","1610","24.07","4131191","33912375600"
"027580","상보","1495","1640","145","9.70","27490647","46220165040"
"038540","상상인","8740","9230","490","5.61","2917482","25682647640"
"101000","상상인인더스트리","747","784","37","4.95","17725466","15088743437"
"415580","상상인제3호스팩","2115","2100","-15","-0.71","376394","791767900"
"001290","상상인증권","960","1055","95","9.90","9712510","11079229262"
"041650","상신브레이크","3260","3385","125","3.83","415358","1402163405"
"091580","상신이디피","15900","18850","2950","18.55","8808959","156870205650"
"263810","상신전자","3370","3510","140","4.15","2013068","7056857090"
"089980","상아프론테크","29650","34700","5050","17.03","1211231","38227078450"
"042940","상지카일룸","1005","1030","25","2.49","17053462","17918457787"
"042600","새로닉스","20400","23700","3300","16.18","1385088","30705871900"
"075180","새론오토모티브","4830","4905","75","1.55","55020","269556015"
"252990","샘씨엔에스","5040","4995","-45","-0.89","5726075","29337228120"
"007540","샘표","57500","51900","-5600","-9.74","1093246","59374127450"
"248170","샘표식품","36000","38750","2750","7.64","1029866","41121500850"
"294630","서남","2730","2995","265","9.71","1472412","4215833095"
"038070","서린바이오","12650","16100","3450","27.27","31390564","536315818800"
"006730","서부T&D","7310","8580","1270","17.37","7788864","61819452860"
"079650","서산","2025","2195","170","8.40","1020544","2241164390"
"100660","서암기계공업","7680","6910","-770","-10.03","21716761","157605069220"
"007860","서연","7250","6970","-280","-3.86","2123603","15007997970"
"200880","서연이화","8130","8770","640","7.87","10232895","90572096610"
"019770","서연탑메탈","6330","5870","-460","-7.27","4426959","26243103370"
"017390","서울가스","243000","251000","8000","3.29","304161","73523632500"
"043710","서울리거","1025","957","-68","-6.63","2088448","2061448506"
"092190","서울바이오시스","7040","6960","-80","-1.14","5356908","39903278160"
"046890","서울반도체","10600","11200","600","5.66","3372762","36789378200"
"004410","서울식품","258","266","8","3.10","129742134","35359906889"
"004415","서울식품우","3230","3380","150","4.64","101825","347134425"
"063170","서울옥션","18800","23600","4800","25.53","7028684","145074742600"
"027040","서울전자통신","692","693","1","0.14","1980541","1315820371"
"018680","서울제약","4980","5310","330","6.63","3335484","20087698925"
"021050","서원","1410","1530","120","8.51","2510929","3599538535"
"093920","서원인텍","5650","5830","180","3.19","539664","3101813740"
"189860","서전기전","9440","9760","320","3.39","5553283","52010656330"
"178320","서진시스템","15150","15900","750","4.95","3493155","54047416050"
"122690","서진오토모티브","3085","3160","75","2.43","998535","3096597495"
"140070","서플러스글로벌","3400","3730","330","9.71","1772778","6389953880"
"011370","서한","1345","1485","140","10.41","12778739","18020898215"
"065710","서호전기","17850","18900","1050","5.88","89428","1654314400"
"008490","서흥","32200","36250","4050","12.58","245787","8452733250"
"035890","서희건설","1420","1520","100","7.04","11904092","16966546545"
"357550","석경에이티","17300","19300","2000","11.56","1843789","33883504650"
"003100","선광","90400","99000","8600","9.51","1035003","97808507400"
"007610","선도전기","3000","3000","0","0.00","0","0"
"067370","선바이오","17350","18300","950","5.48","102483","1778128450"
"171090","선익시스템","16400","17900","1500","9.15","3503826","61746224300"
"136490","선진","10150","11300","1150","11.33","1676570","17461967240"
"086710","선진뷰티사이언스","5940","6540","600","10.10","1582519","9972019680"
"014620","성광벤드","11050","14750","3700","33.48","13929398","169076787050"
"037350","성도이엔지","5200","5560","360","6.92","2467742","13001627075"
"014910","성문전자","1800","1990","190","10.56","4006559","7975098320"
"014915","성문전자우","8240","8750","510","6.19","12890","109333800"
"003080","성보화학","3590","3785","195","5.43","2406484","8688225845"
"004980","성신양회","9450","10600","1150","12.17","4956042","50518023590"
"004985","성신양회우","13350","15100","1750","13.11","1005574","16230319650"
"011300","성안","593","1090","497","83.81","159079099","157260966118"
"081580","성우전자","2905","3040","135","4.65","678250","1996019260"
"045300","성우테크론","4660","5040","380","8.15","4879527","24433861095"
"015750","성우하이텍","4370","5440","1070","24.49","41322061","224366341195"
"000180","성창기업지주","2000","2205","205","10.25","6546719","13978280505"
"080470","성창오토텍","6810","7530","720","10.57","602054","4444346230"
"043260","성호전자","1505","1495","-10","-0.66","8246410","12617814600"
"148150","세경하이테크","17000","19950","2950","17.35","1548815","30038590150"
"002420","세기상사","8360","9580","1220","14.59","673941","6464936910"
"053060","세동","1395","1610","215","15.41","11607709","17755866145"
"340440","세림B&G","4040","3795","-245","-6.06","182726304","716927117560"
"017510","세명전기","3920","3900","-20","-0.51","894317","3409210630"
"004360","세방","10350","12850","2500","24.15","979977","11301955120"
"004365","세방우","6830","7070","240","3.51","21259","147928330"
"004490","세방전지","50900","55100","4200","8.25","868164","45748935350"
"011560","세보엠이씨","8230","8620","390","4.74","1496566","12195864470"
"396300","세아메카닉스","6860","7770","910","13.27","65665977","496151707640"
"001430","세아베스틸지주","15100","15500","400","2.65","883563","13149296850"
"306200","세아제강","151000","175000","24000","15.89","528082","84423066500"
"003030","세아제강지주","128000","162500","34500","26.95","499254","73345984500"
"019440","세아특수강","14050","14200","150","1.07","172203","2370864950"
"058650","세아홀딩스","95800","102500","6700","6.99","3911","382345900"
"013000","세우글로벌","1640","1690","50","3.05","2602233","4269113565"
"100700","세운메디칼","3280","3510","230","7.01","10656743","38160192645"
"024830","세원물산","6280","6280","0","0.00","0","0"
"091090","세원이앤씨","636","851","215","33.81","77858976","64297327661"
"021820","세원정공","8090","8090","0","0.00","0","0"
"067830","세이브존I&C","2895","2900","5","0.17","699893","2044204795"
"033530","세종공업","5390","6180","790","14.66","7041227","42042281160"
"258830","세종메디칼","4140","5580","1440","34.78","215710160","1418423696075"
"036630","세종텔레콤","778","789","11","1.41","8000264","6436682230"
"039310","세중","2850","2955","105","3.68","1476905","4277796805"
"075580","세진중공업","5810","7470","1660","28.57","9316541","62297796190"
"067770","세진티에스","3615","3745","130","3.60","269541","1006458555"
"053450","세코닉스","7770","8170","400","5.15","1195972","9386182080"
"027970","세하","1315","1365","50","3.80","1760925","2385352855"
"252500","세화피앤씨","1350","1400","50","3.70","2981116","4042969395"
"347000","센코","12650","14600","1950","15.42","233841","3171816800"
"308170","센트랄모텍","12900","18650","5750","44.57","17035550","294555611800"
"012600","센트럴인사이트","2490","2490","0","0.00","0","0"
"331920","셀레믹스","7120","8620","1500","21.07","3909933","38249555110"
"049180","셀루메드","4415","6160","1745","39.52","48572528","287979259100"
"299660","셀리드","20450","23600","3150","15.40","12125276","312205306500"
"268600","셀리버리","16050","17150","1100","6.85","10888796","298990756950"
"108860","셀바스AI","6910","7350","440","6.37","4564750","32809040560"
"208370","셀바스헬스케어","2305","2310","5","0.22","983925","2296756455"
"258250","셀젠텍","7050","6960","-90","-1.28","26810","185043740"
"068270","셀트리온","182500","212500","30000","16.44","9560584","1848111158000"
"068760","셀트리온제약","79400","89900","10500","13.22","2639396","219461679700"
"091990","셀트리온헬스케어","71500","79200","7700","10.77","14349195","1044240233500"
"060230","소니드","3640","4095","455","12.50","12902930","50065923850"
"290690","소룩스","8810","8590","-220","-2.50","395741","3426172730"
"053110","소리바다","3960","3960","0","0.00","0","0"
"950200","소마젠","5590","6160","570","10.20","2763700","17766342200"
"032680","소프트센","1770","1870","100","5.65","29656503","58028462115"
"032685","소프트센우","26350","24350","-2000","-7.59","26574","644119300"
"258790","소프트캠프","1725","1765","40","2.32","5032435","9519734900"
"066910","손오공","2305","2225","-80","-3.47","1761482","3981531400"
"043100","솔고바이오","574","591","17","2.96","5586685","3280037705"
"336370","솔루스첨단소재","42850","46850","4000","9.33","6826362","289486890700"
"33637K","솔루스첨단소재1우","10600","11350","750","7.08","605117","6252893080"
"33637L","솔루스첨단소재2우B","13800","14350","550","3.99","424708","6236341600"
"154040","솔루에타","2825","2865","40","1.42","327228","926231620"
"248070","솔루엠","19400","21500","2100","10.82","2047336","41776531850"
"035610","솔본","3695","4185","490","13.26","6041704","26396460755"
"357780","솔브레인","229600","226000","-3600","-1.57","461354","103831383300"
"036830","솔브레인홀딩스","19550","22150","2600","13.30","447855","9087125300"
"304100","솔트룩스","9320","10000","680","7.30","652771","6509861750"
"004430","송원산업","19800","19000","-800","-4.04","8373033","159840238800"
"086980","쇼박스","4860","5090","230","4.73","53778132","292808616815"
"050960","수산아이앤티","11150","12150","1000","8.97","629181","7231849150"
"017550","수산중공업","3185","3095","-90","-2.83","16300423","48958655095"
"253840","수젠텍","15850","13950","-1900","-11.99","28029916","477425352050"
"185190","수프로","1520","1395","-125","-8.22","32133","82346820"
"236200","슈프리마","21700","24100","2400","11.06","593657","13959113450"
"317770","슈프리마아이디","14550","16200","1650","11.34","2082417","34537551700"
"094840","슈프리마에이치큐","6010","6600","590","9.82","416009","2619657490"
"192440","슈피겐코리아","38050","37650","-400","-1.05","94956","3571505100"
"136510","스마트솔루션즈","11600","11600","0","0.00","0","0"
"099440","스맥","2595","2660","65","2.50","27876132","71226572880"
"053210","스카이라이프","9070","10000","930","10.25","10041343","94624889180"
"033790","스카이문스테크놀로지","829","829","0","0.00","0","0"
"131100","스카이이앤엠","2935","3250","315","10.73","450688","1386908095"
"276040","스코넥","12150","12950","800","6.58","4680307","61327878000"
"159910","스킨앤스킨","236","231","-5","-2.12","134905726","33834637723"
"115570","스타플렉스","4375","4360","-15","-0.34","629238","2715569130"
"258540","스템랩","2990","2460","-530","-17.73","91168","213929070"
"330730","스톤브릿지벤처스","5850","6130","280","4.79","9083371","58828022750"
"253450","스튜디오드래곤","73600","82100","8500","11.55","3069678","235350315100"
"204630","스튜디오산타클로스","7140","9100","1960","27.45","9965730","105014231530"
"026890","스틱인베스트먼트","7310","8240","930","12.72","13617571","110952939820"
"013810","스페코","5830","6500","670","11.49","11253393","69033821230"
"049830","승일","14850","14850","0","0.00","15047729","235220964050"
"020710","시공테크","5300","5520","220","4.15","3500352","19131654285"
"033170","시그네틱스","1635","1705","70","4.28","22544270","39134127115"
"048870","시너지이노베이션","3680","4210","530","14.40","6985114","27939889255"
"025320","시노펙스","3305","3400","95","2.87","118180678","406326722735"
"134790","시디즈","51100","49050","-2050","-4.01","1350029","72316866000"
"269620","시스웍","889","889","0","0.00","0","0"
"131090","시큐브","1055","1110","55","5.21","1443595","1548416990"
"232830","시큐센","2815","4270","1455","51.69","59875","208063755"
"139050","시티랩스","614","608","-6","-0.98","5346170","3230250567"
"016590","신대양제지","87000","86300","-700","-0.80","28813","2512783700"
"290520","신도기연","4885","5280","395","8.09","1811574","10032026355"
"029530","신도리코","31350","32050","700","2.23","231128","7316426636"
"004970","신라교역","10400","10800","400","3.85","128117","1361500650"
"001000","신라섬유","1765","2145","380","21.53","48725991","105601030400"
"025870","신라에스지","10500","11250","750","7.14","1272671","14680015550"
"215600","신라젠","12100","12100","0","0.00","0","0"
"065350","신성델타테크","10300","12000","1700","16.50","2711470","30224534660"
"011930","신성이엔지","1915","2370","455","23.76","142930611","315910064655"
"005390","신성통상","2945","3135","190","6.45","15800407","48452437405"
"004170","신세계","217500","227500","10000","4.60","1029082","224196434000"
"035510","신세계 I&C","13850","15150","1300","9.39","697256","9959639750"
"034300","신세계건설","25400","26750","1350","5.31","134698","3414246000"
"031430","신세계인터내셔날","29850","30050","200","0.67","2682131","79776899550"
"031440","신세계푸드","57800","62000","4200","7.27","123585","7383478200"
"006880","신송홀딩스","13050","10100","-2950","-22.61","11182068","124389834930"
"002800","신신제약","5250","5470","220","4.19","1318447","7339018330"
"344050","신영스팩6호","2285","2285","0","0.00","0","0"
"419270","신영스팩7호","2145","2135","-10","-0.47","316418","679073225"
"005800","신영와코루","11600","11900","300","2.59","172953","1997730650"
"001720","신영증권","55100","57100","2000","3.63","51721","2887623200"
"001725","신영증권우","57000","58200","1200","2.11","16015","916609400"
"009270","신원","1655","1800","145","8.76","15130943","25649570800"
"017000","신원종합개발","7230","7950","720","9.96","7810249","59615552330"
"002700","신일전자","2210","1905","-305","-13.80","46404499","96733859570"
"012790","신일제약","8900","9700","800","8.99","5682477","59843347800"
"138070","신진에스엠","5154","4115","-1039","-20.16","46157512","459618119610"
"226330","신테카바이오","9600","11000","1400","14.58","1516477","16074255030"
"019170","신풍제약","24600","28600","4000","16.26","34812317","1080766682450"
"019175","신풍제약우","46000","46150","150","0.33","278600","13822217550"
"002870","신풍제지","1580","1740","160","10.13","29166470","56821802165"
"404990","신한서부티엔디리츠","5020","4780","-240","-4.78","1656412","8009622225"
"293940","신한알파리츠","7790","7800","10","0.13","2154471","16737310440"
"333050","신한제6호스팩","2350","2165","-185","-7.87","24626624","65153012405"
"366330","신한제7호스팩","2135","2120","-15","-0.70","3474907","7798996905"
"393360","신한제8호스팩","2150","2150","0","0.00","248507","533953655"
"405640","신한제9호스팩","2145","2125","-20","-0.93","424078","904661405"
"055550","신한지주","36250","36050","-200","-0.55","29117163","1028170383335"
"056700","신화인터텍","4200","5140","940","22.38","193456268","1000504549920"
"187270","신화콘텍","5970","5750","-220","-3.69","10365995","62659925430"
"004080","신흥","16300","16000","-300","-1.84","35447","568911650"
"243840","신흥에스이씨","52600","58000","5400","10.27","946719","51860070500"
"257720","실리콘투","4425","2685","-1740","-39.32","44007981","218237350170"
"222800","심텍","38000","37850","-150","-0.39","18457149","740548491900"
"036710","심텍홀딩스","3840","4225","385","10.03","21967008","99976493920"
"160980","싸이맥스","13850","14500","650","4.69","546686","7993902650"
"356890","싸이버원","10800","11400","600","5.56","11782974","156423261950"
"217330","싸이토젠","58400","60100","1700","2.91","144154","8501631300"
"102280","쌍방울","545","542","-3","-0.55","101420891","55714818489"
"003410","쌍용C&E","6520","6870","350","5.37","10236765","66861252420"
"010280","쌍용정보통신","1160","1075","-85","-7.33","8370377","9100750720"
"003620","쌍용차","2770","2770","0","0.00","0","0"
"004770","써니전자","2725","2855","130","4.77","27428359","77983025225"
"217320","썬테크","6710","5310","-1400","-20.86","347","2404940"
"208640","썸에이지","1135","1180","45","3.96","21315385","26071890875"
"222420","쎄노텍","2035","2140","105","5.16","12470570","26611560580"
"037760","쎄니트","1660","1905","245","14.76","19584527","37735122675"
"099320","쎄트렉아이","32950","36300","3350","10.17","1276751","44292271450"
"015540","쎌마테라퓨틱스","6410","6410","0","0.00","0","0"
"049960","쎌바이오텍","13850","13700","-150","-1.08","213287","2949821850"
"050890","쏠리드","5040","5520","480","9.52","3857606","20430966395"
"066790","씨씨에스","549","518","-31","-5.65","3974719","2109692273"
"222080","씨아이에스","13650","15600","1950","14.29","22939475","335138248900"
"004920","씨아이테크","1270","1240","-30","-2.36","26106798","35124078240"
"236030","씨알푸드","6590","6930","340","5.16","74","480850"
"103660","씨앗","5950","5950","0","0.00","0","0"
"352480","씨앤씨인터내셔널","17400","19900","2500","14.37","592280","11807930750"
"245450","씨앤에스링크","2080","2060","-20","-0.96","14","29125"
"264660","씨앤지하이테크","11500","12000","500","4.35","479324","5850802550"
"352700","씨앤투스성진","5290","5700","410","7.75","9675914","55810529040"
"297090","씨에스베어링","9760","12550","2790","28.59","68012784","723156853160"
"112610","씨에스윈드","49150","65300","16150","32.86","7352003","403471087600"
"359090","씨엔알리서치","1780","1705","-75","-4.21","1666586","2881212545"
"286000","씨엔티드림","3210","2595","-615","-19.16","65327","168407950"
"115530","씨엔플러스","536","679","143","26.68","16094794","9952358529"
"115480","씨유메디칼","1075","1150","75","6.98","9720665","10714474118"
"376290","씨유테크","4660","5270","610","13.09","5820289","33154809700"
"189330","씨이랩","13150","13800","650","4.94","303683","4014481050"
"096530","씨젠","44700","39750","-4950","-11.07","19978867","885135158450"
"900120","씨케이에이치","252","270","18","7.14","40268720","10639102489"
"101240","씨큐브","6670","7120","450","6.75","324431","2192829250"
"060590","씨티씨바이오","8200","8870","670","8.17","1451038","12190408060"
"260930","씨티케이","7050","7850","800","11.35","729703","5418251350"
"013990","아가방컴퍼니","2960","3135","175","5.91","1705405","5193406235"
"123860","아나패스","22050","24050","2000","9.07","345892","8113247650"
"025980","아난티","6740","7620","880","13.06","9231017","64288481050"
"008700","아남전자","2350","2800","450","19.15","118121349","317947790020"
"058220","아리온","275","275","0","0.00","0","0"
"125210","아모그린텍","11100","13600","2500","22.52","6580274","80828001400"
"002790","아모레G","37800","35850","-1950","-5.16","2505375","92999305050"
"00279K","아모레G3우(전환)","31950","29550","-2400","-7.51","56205","1745608550"
"002795","아모레G우","14450","14150","-300","-2.08","156751","2247581350"
"090430","아모레퍼시픽","133000","127000","-6000","-4.51","5081757","664917952000"
"090435","아모레퍼시픽우","49800","48000","-1800","-3.61","396437","19180788997"
"357580","아모센스","12650","16200","3550","28.06","5514608","82912304000"
"052710","아모텍","21750","26400","4650","21.38","871485","21207566700"
"074430","아미노로직스","2740","2605","-135","-4.93","34264275","86947858950"
"092040","아미코젠","24300","26500","2200","9.05","1768720","43168005400"
"083930","아바코","10400","11750","1350","12.98","1284798","14093059050"
"149950","아바텍","15000","15950","950","6.33","465427","7747195350"
"036010","아비코전자","10050","12150","2100","20.90","4793994","52607168080"
"002030","아세아","114000","125000","11000","9.65","45651","5393924500"
"183190","아세아시멘트","11150","12900","1750","15.70","2975366","34550826970"
"002310","아세아제지","33700","37150","3450","10.24","391789","13839481250"
"050860","아세아텍","2850","3055","205","7.19","3384034","9951716950"
"012170","아센디오","1330","1140","-190","-14.29","5752837","6935830400"
"136410","아셈스","14000","15250","1250","8.93","5761189","87607864650"
"246720","아스타","4085","4260","175","4.28","348573","1457768315"
"067390","아스트","5090","5250","160","3.14","2034134","11319151075"
"159010","아스플로","7703","12100","4397","57.08","17490342","260525096650"
"127710","아시아경제","2075","2180","105","5.06","2676727","5975007475"
"267850","아시아나IDT","14300","14000","-300","-2.10","265143","3714755850"
"020560","아시아나항공","15250","15150","-100","-0.66","6355858","93741672650"
"154030","아시아종묘","4390","4440","50","1.14","3022022","14264185015"
"227610","아우딘퓨쳐스","1505","1760","255","16.94","5236888","8490522895"
"143160","아이디스","23450","26150","2700","11.51","243327","5979165350"
"054800","아이디스홀딩스","12700","13300","600","4.72","170284","2244987000"
"332370","아이디피","7730","8820","1090","14.10","666014","5587428790"
"122900","아이마켓코리아","10250","10350","100","0.98","751474","7661681010"
"339950","아이비김영","2135","2450","315","14.75","40055938","107653966950"
"099190","아이센스","32750","37500","4750","14.50","1969404","68987517000"
"289010","아이스크림에듀","4445","5180","735","16.54","21553443","120885532345"
"214430","아이쓰리시스템","17050","19100","2050","12.02","497118","9215196650"
"040910","아이씨디","9200","9590","390","4.24","321791","2992205310"
"068940","아이씨케이","3865","4180","315","8.15","18679932","73221133740"
"052860","아이앤씨","2950","3015","65","2.20","604370","1771318160"
"010780","아이에스동서","40800","41550","750","1.84","1328120","53225932850"
"069920","아이에스이커머스","8160","8030","-130","-1.59","8931451","73847335280"
"038880","아이에이","803","819","16","1.99","24113612","19562211268"
"307180","아이엘사이언스","4035","4025","-10","-0.25","2531279","9737462580"
"101390","아이엠","4780","5310","530","11.09","875516","4518606205"
"078860","아이오케이","721","745","24","3.33","17195001","13252963197"
"114810","아이원스","7310","8020","710","9.71","1675366","12966995170"
"090150","아이윈","1810","2340","530","29.28","40949374","91567377835"
"123010","아이윈플러스","720","679","-41","-5.69","46148678","29737211274"
"031310","아이즈비전","2900","3035","135","4.66","1480034","4468990395"
"185490","아이진","9650","10750","1100","11.40","7197235","76711355490"
"059100","아이컴포넌트","6510","6680","170","2.61","358992","2392256660"
"149010","아이케이세미콘","7970","7400","-570","-7.15","21300","160310420"
"262840","아이퀘스트","8880","9430","550","6.19","10778993","102330425980"
"175250","아이큐어","13300","12900","-400","-3.01","3755275","52437174800"
"052460","아이크래프트","3550","3740","190","5.35","5066357","20101063590"
"119830","아이텍","9380","8390","-990","-10.55","6973566","64192090760"
"052770","아이톡시","2085","2085","0","0.00","0","0"
"124500","아이티센","4155","4305","150","3.61","1435234","5946752545"
"372800","아이티아이즈","12600","12400","-200","-1.59","7551287","89128994020"
"084850","아이티엠반도체","32050","35250","3200","9.98","418419","13867682550"
"114840","아이패밀리에스씨","12200","12750","550","4.51","1567969","19303778250"
"027360","아주IB투자","2965","3210","245","8.26","63623067","214098254060"
"139990","아주스틸","10400","11550","1150","11.06","1609536","18423358850"
"032080","아즈텍WB","2200","2555","355","16.14","28128377","73523860950"
"013310","아진산업","2705","3015","310","11.46","10011069","29131364860"
"059120","아진엑스텍","9550","11050","1500","15.71","4473802","47850402870"
"158430","아톤","28750","29900","1150","4.00","842029","24906357500"
"149300","아퓨어스","1680","1680","0","0.00","17398","28304145"
"067160","아프리카TV","83400","84800","1400","1.68","4639284","399080718800"
"001540","안국약품","8370","9320","950","11.35","4797370","47847229690"
"053800","안랩","88900","92900","4000","4.50","3352130","302749710100"
"251280","안지오랩","9970","9400","-570","-5.72","27220","244812320"
"065660","안트로젠","21400","22450","1050","4.91","1105574","24392035650"
"297570","알로이스","1635","2125","490","29.97","102299242","222171355445"
"001780","알루코","2950","3205","255","8.64","12623917","38765377700"
"260660","알리코제약","6240","6820","580","9.29","2049314","14016784490"
"361570","알비더블유","17950","18150","200","1.11","10319834","204346802250"
"131370","알서포트","4720","5170","450","9.53","23491286","127657157030"
"140670","알에스오토메이션","13350","15700","2350","17.60","8159448","128699754000"
"096610","알에프세미","3080","4110","1030","33.44","17142681","71436972505"
"061040","알에프텍","5280","5690","410","7.77","3737735","20458491280"
"148250","알엔투테크놀로지","8330","8110","-220","-2.64","1788140","15084268080"
"347860","알체라","13700","16050","2350","17.15","1464213","21958885750"
"196170","알테오젠","63900","74600","10700","16.74","8613955","587733600500"
"123750","알톤스포츠","3205","3610","405","12.64","8608558","31128348460"
"085810","알티캐스트","1600","1740","140","8.75","3864081","6600538560"
"117670","알파홀딩스","2490","2340","-150","-6.02","4882262","11758995255"
"291650","압타머사이언스","13200","10650","-2550","-19.32","11843508","150143009550"
"293780","압타바이오","17050","19100","2050","12.02","31685249","712090981600"
"267810","앙츠","1335","1305","-30","-2.25","3765","5486745"
"018250","애경산업","14450","14150","-300","-2.08","410688","5954911600"
"161000","애경케미칼","8260","8580","320","3.87","1616585","13189348960"
"196300","애니젠","9470","9440","-30","-0.32","214155","1980701390"
"310200","애니플러스","2860","3210","350","12.24","7876998","25115844775"
"179530","애드바이오텍","4780","5060","280","5.86","1996040","9766043820"
"900100","애머릿지","3585","3585","0","0.00","0","0"
"205500","액션스퀘어","2700","3350","650","24.07","14655653","47550099235"
"052790","액토즈소프트","9040","9880","840","9.29","522634","4944792700"
"290740","액트로","7230","7390","160","2.21","988838","7158808690"
"238090","앤디포스","6800","7300","500","7.35","5329998","39995231210"
"092600","앤씨앤","2905","2425","-480","-16.52","4969503","12510609105"
"129890","앱코","11450","11400","-50","-0.44","1024219","11641894250"
"174900","앱클론","11450","12700","1250","10.92","3196682","41051386650"
"255440","야스","9170","9380","210","2.29","239002","2283411700"
"030960","양지사","7420","16100","8680","116.98","20179358","271840527590"
"102120","어보브반도체","9950","10800","850","8.54","1761724","18179769910"
"263540","어스앤에어로스페이스","10900","10900","0","0.00","0","0"
"238120","얼라인드","9860","10200","340","3.45","551480","5505996610"
"224810","엄지하우스","6470","4775","-1695","-26.20","4618","20594555"
"019990","에너토크","10700","12050","1350","12.62","3494670","38150849480"
"011090","에넥스","1370","1605","235","17.15","16701913","25576142085"
"270660","에브리봇","29500","35850","6350","21.53","7879542","289317217100"
"038680","에스넷","5560","6140","580","10.43","5019164","32344041910"
"137310","에스디바이오센서","43900","39200","-4700","-10.71","15559964","699944311450"
"217480","에스디생명공학","1960","2925","965","49.23","14372725","39382125745"
"121890","에스디시스템","739","739","0","0.00","0","0"
"097780","에스맥","3385","3385","0","0.00","0","0"
"042110","에스씨디","2250","1875","-375","-16.67","19587304","40271483700"
"298060","에스씨엠생명과학","10950","11250","300","2.74","1118581","12859381850"
"065420","에스아이리소스","699","787","88","12.59","52788021","41496914425"
"270210","에스알바이오텍","4205","3870","-335","-7.97","2734","10414390"
"103230","에스앤더블류","2505","2505","0","0.00","0","0"
"260970","에스앤디","19050","20000","950","4.99","280646","5350978850"
"101490","에스앤에스텍","19650","20200","550","2.80","1967690","39590912900"
"095910","에스에너지","4335","5460","1125","25.95","54826514","268368047035"
"275630","에스에스알","4780","5530","750","15.69","392609","2060417955"
"031330","에스에이엠티","3540","3685","145","4.10","2768226","10060771025"
"060540","에스에이티","2715","2705","-10","-0.37","3003604","8080852985"
"351320","에스에이티이엔지","3570","3625","55","1.54","2097630","7648507885"
"056190","에스에프에이","39850","42600","2750","6.90","2562650","106472551050"
"080000","에스엔유","2895","3010","115","3.97","1013355","3033445020"
"086460","에스엔피제네틱스","10000","7900","-2100","-21.00","13753","106122180"
"005850","에스엘","28900","30950","2050","7.09","4059247","126913965550"
"214310","에스엘바이오닉스","3490","5790","2300","65.90","3629521","17368795660"
"246250","에스엘에스바이오","7100","7000","-100","-1.41","61753","451217300"
"041510","에스엠","68500","74300","5800","8.47","8085886","572679469100"
"010580","에스엠벡셀","1530","1530","0","0.00","0","0"
"299670","에스엠비나","3000","2785","-215","-7.17","155","441675"
"007820","에스엠코어","6140","7070","930","15.15","5803959","39252126480"
"109610","에스와이","3775","3685","-90","-2.38","32376984","117993661405"
"012750","에스원","63700","62400","-1300","-2.04","928640","58591632150"
"306040","에스제이그룹","21050","22200","1150","5.46","455687","9714952750"
"217910","에스제이켐","310","304","-6","-1.94","42669","12956073"
"224020","에스케이씨에스","3740","4340","600","16.04","13938","54222170"
"408920","에스케이증권7호스팩","2185","2185","0","0.00","0","0"
"096630","에스코넥","1170","1235","65","5.56","1786657","2111514545"
"069510","에스텍","6650","7530","880","13.23","376604","2748948840"
"041910","에스텍파마","7720","8890","1170","15.16","3348418","29928080050"
"234300","에스트래픽","3880","4130","250","6.44","2256308","9701757745"
"039440","에스티아이","15750","15350","-400","-2.54","3315908","53592535350"
"098660","에스티오","2370","2315","-55","-2.32","906141","2030418685"
"052020","에스티큐브","7160","19500","12340","172.35","34436150","465931585520"
"237690","에스티팜","95100","117000","21900","23.03","2873705","293884497500"
"050760","에스폴리텍","3395","3590","195","5.74","6395441","23761369775"
"288620","에스퓨얼셀","22100","24800","2700","12.22","1519893","34331806000"
"317830","에스피시스템스","10100","10550","450","4.46","8927853","91688190042"
"058610","에스피지","12850","17350","4500","35.02","18269708","274735502300"
"043340","에쎈테크","1240","1020","-220","-17.74","8694753","9561656785"
"023960","에쓰씨엔지니어링","2365","2280","-85","-3.59","6204928","14100684185"
"298690","에어부산","3859","3560","-299","-7.75","4801520","7914586710"
"187660","에이디엠코리아","3150","3120","-30","-0.95","3831881","12310931705"
"054630","에이디칩스","291","352","61","20.96","98815368","38697946561"
"200710","에이디테크놀로지","13300","14100","800","6.02","851103","11725681750"
"096690","에이루트","428","522","94","21.96","177326408","96200988341"
"140910","에이리츠","5570","5640","70","1.26","109933","594534290"
"078520","에이블씨엔씨","5260","5230","-30","-0.57","909518","4798878400"
"298380","에이비엘바이오","25500","25500","0","0.00","12225710","293480078700"
"203400","에이비온","8150","10600","2450","30.06","2839423","27911300570"
"195990","에이비프로바이오","854","840","-14","-1.64","34512914","30072129977"
"003800","에이스침대","40950","43000","2050","5.01","11964","503770150"
"088800","에이스테크","7240","7900","660","9.12","4106935","31070892650"
"241840","에이스토리","27750","26600","-1150","-4.14","17693276","548117294000"
"312610","에이에프더블류","3345","3750","405","12.11","4068986","15864530815"
"015260","에이엔피","2445","2330","-115","-4.70","4435826","10191113680"
"234070","에이원알폼","24850","24850","0","0.00","0","0"
"072990","에이치시티","11000","10600","-400","-3.64","507599","5589435100"
"227100","에이치앤비디자인","7090","4780","-2310","-32.58","4565359","26220196705"
"044990","에이치엔에스하이텍","12150","12150","0","0.00","0","0"
"239610","에이치엘사이언스","35450","30800","-4650","-13.12","61893","1989010200"
"353070","에이치엠씨제4호스팩","2115","2105","-10","-0.47","175485","371467015"
"353060","에이치엠씨제5호스팩","2120","2100","-20","-0.94","187274","393929330"
"044780","에이치케이","1830","1900","70","3.83","1745292","3154308090"
"357230","에이치피오","9610","11950","2340","24.35","4349646","52955913740"
"071670","에이테크솔루션","12600","13250","650","5.16","1403029","17757683400"
"045660","에이텍","12550","12950","400","3.19","4759586","60501183550"
"224110","에이텍티앤","13200","12250","-950","-7.20","1758849","22881147300"
"230980","에이트원","849","1015","166","19.55","32519947","34115553387"
"021080","에이티넘인베스트","3190","3510","320","10.03","18047107","63149028075"
"089530","에이티세미콘","1130","1090","-40","-3.54","18015845","20078261932"
"200470","에이팩트","4000","5040","1040","26.00","23815805","132954808640"
"207490","에이펙스인텍","7450","8010","560","7.52","2490","19985140"
"262260","에이프로","11150","13400","2250","20.18","3105266","41182969550"
"007460","에이프로젠","1595","1500","-95","-5.96","60896198","94193503730"
"109960","에이프로젠 H&G","518","533","15","2.90","2972256","1582899320"
"003060","에이프로젠제약","595","674","79","13.28","18494774","12103165634"
"244920","에이플러스에셋","6030","6300","270","4.48","1873965","11726972040"
"089970","에이피티씨","16050","17300","1250","7.79","3297324","54155061450"
"230240","에치에프알","27650","33300","5650","20.43","1877865","57517991750"
"230360","에코마케팅","14800","17950","3150","21.28","5468910","94352781000"
"038870","에코바이오","6720","6890","170","2.53","940790","6311213180"
"128540","에코캡","6230","7980","1750","28.09","56873779","434740201630"
"086520","에코프로","71400","118900","47500","66.53","26564707","2555313748100"
"247540","에코프로비엠","118900","122500","3600","3.03","26307671","3134960391100"
"383310","에코프로에이치엔","37750","60900","23150","61.32","7627910","409323940500"
"038110","에코플라스틱","2735","3010","275","10.05","49353128","147267851660"
"073540","에프알텍","3070","3130","60","1.95","717548","2201413035"
"064850","에프앤가이드","6410","7990","1580","24.65","5219237","40594859180"
"064090","에프앤리퍼블릭","2585","2790","205","7.93","393631","1050897270"
"036810","에프에스티","14650","15300","650","4.44","947221","14121463850"
"173940","에프엔씨엔터","5900","5630","-270","-4.58","387666","2257198270"
"083500","에프엔에스테크","8010","9340","1330","16.60","737890","6350438410"
"054940","엑사이엔씨","1140","1195","55","4.82","2545173","2903424555"
"950130","엑세스바이오","17200","17500","300","1.74","50364313","998098327950"
"205100","엑셈","3785","4190","405","10.70","6557868","26534930770"
"070300","엑스큐어","2555","3105","550","21.53","388984","1151071200"
"092870","엑시콘","9280","9800","520","5.60","846559","8256348230"
"317870","엔바이오니아","11200","8470","-2730","-24.38","786866","7279580970"
"067570","엔브이에이치코리아","3465","3775","310","8.95","1447823","5218241300"
"236810","엔비티","7390","7170","-220","-2.98","3456355","26156828230"
"140610","엔솔바이오사이언스","14000","13000","-1000","-7.14","140651","1880187050"
"333620","엔시스","13500","14950","1450","10.74","472291","6651104500"
"101400","엔시트론","781","794","13","1.66","6016855","4745276720"
"036570","엔씨소프트","373500","400500","27000","7.23","2160087","817743999750"
"217820","엔에스","8360","8790","430","5.14","1613865","14588493160"
"031860","엔에스엔","1200","1285","85","7.08","21933329","26597870840"
"238170","엔에스엠","766","849","83","10.84","39266","27347927"
"224760","엔에스컴퍼니","3295","2450","-845","-25.64","6092","15962555"
"380440","엔에이치스팩19호","2100","2080","-20","-0.95","1527781","3198777545"
"391060","엔에이치스팩20호","2100","2085","-15","-0.71","642813","1345702285"
"396770","엔에이치스팩22호","2150","2150","0","0.00","236981","509735720"
"422040","엔에이치스팩23호","2115","2115","0","0.00","465052","987889920"
"265740","엔에프씨","11250","10900","-350","-3.11","443284","4942035400"
"354200","엔젠바이오","8180","8780","600","7.33","2155152","22131262460"
"093510","엔지브이아이","2000","2000","0","0.00","100","198875"
"208860","엔지스테크널러지","2205","2205","0","0.00","0","0"
"183490","엔지켐생명과학","17000","21050","4050","23.82","11565001","266792985800"
"085310","엔케이","873","988","115","13.17","1873938","1707407918"
"182400","엔케이맥스","15300","16900","1600","10.46","10552450","174102892650"
"348370","엔켐","47100","57600","10500","22.29","2696551","136247318350"
"069410","엔텔스","5640","6090","450","7.98","888981","5368204490"
"227950","엔투텍","1385","1335","-50","-3.61","8254987","11574846845"
"291230","엔피","7210","7760","550","7.63","13387108","107234893190"
"198080","엔피디","2380","2550","170","7.14","372527","922966735"
"048830","엔피케이","2020","2245","225","11.14","3284405","7099357605"
"096870","엘디티","3685","3695","10","0.27","399359","1475096930"
"276240","엘리비젼","598","749","151","25.25","16375","9387793"
"900140","엘브이엠씨홀딩스","2920","3065","145","4.97","3106875","9129297610"
"376190","엘비루셈","7310","7800","490","6.70","360738","2759742410"
"061970","엘비세미콘","8310","9360","1050","12.64","7968964","72307735830"
"138690","엘아이에스","982","982","0","0.00","0","0"
"290650","엘앤씨바이오","31700","28650","-3050","-9.62","2853534","86407053750"
"066970","엘앤에프","214200","244600","30400","14.19","9916787","2245029090600"
"156100","엘앤케이바이오","10350","11500","1150","11.11","1071110","12615044700"
"311060","엘에이티","3800","4700","900","23.68","10301","41385045"
"073110","엘엠에스","7960","8070","110","1.38","297226","2373691580"
"083310","엘오티베큠","12450","11700","-750","-6.02","2258345","27917144100"
"037950","엘컴텍","1150","1180","30","2.61","7096812","8267698115"
"170920","엘티씨","8130","8690","560","6.89","298051","2467467240"
"058630","엠게임","7590","8270","680","8.96","6590955","52641514840"
"058970","엠로","16500","15300","-1200","-7.27","738792","11974463450"
"019590","엠벤처투자","1205","1480","275","22.82","16324961","23311170800"
"169330","엠브레인","3545","3580","35","0.99","550236","1945872405"
"097520","엠씨넥스","31050","34650","3600","11.59","1129789","36835839000"
"179290","엠아이텍","9170","12300","3130","34.13","11747687","124160011880"
"009780","엠에스씨","5790","6090","300","5.18","141421","843777250"
"123040","엠에스오토텍","4295","4905","610","14.20","2601486","12477341640"
"323230","엠에프엠코리아","889","946","57","6.41","1031914","948096911"
"033160","엠케이전자","11000","13350","2350","21.36","3740869","44866177650"
"347890","엠투아이","8250","9480","1230","14.91","2598715","23502082140"
"033310","엠투엔","6400","8670","2270","35.47","17740504","147222448790"
"259630","엠플러스","14750","16600","1850","12.54","2247952","36253233800"
"065150","엠피대산","569","569","0","0.00","2578380","1457147255"
"115960","연우","17250","18100","850","4.93","494818","8579509700"
"090740","연이비앤티","2105","2105","0","0.00","0","0"
"060850","영림원소프트랩","8630","10650","2020","23.41","3531651","36026693170"
"014440","영보화학","3625","4220","595","16.41","5135941","21212910960"
"007530","영신금속","2705","2680","-25","-0.92","442470","1185994980"
"143540","영우디에스피","1530","1925","395","25.82","110578016","220232744435"
"111770","영원무역","39650","41700","2050","5.17","1974217","79251972728"
"009970","영원무역홀딩스","47300","46850","-450","-0.95","382310","18233942100"
"003520","영진약품","3555","3615","60","1.69","7194392","25997686865"
"000670","영풍","511000","588000","77000","15.07","19846","10660454500"
"036560","영풍정밀","8560","9200","640","7.48","1799559","17060104860"
"006740","영풍제지","7280","7260","-20","-0.27","5136147","38177547570"
"012280","영화금속","1100","1205","105","9.55","4201702","4853424865"
"265560","영화테크","12700","14000","1300","10.24","2871496","38453079850"
"012160","영흥","785","847","62","7.90","2653557","2183708319"
"036000","예림당","1900","1975","75","3.95","379028","725926590"
"250930","예선테크","1325","1460","135","10.19","5902022","8744801180"
"053280","예스24","6370","6760","390","6.12","1262117","8368123330"
"015360","예스코홀딩스","34600","35150","550","1.59","56927","2003278550"
"122640","예스티","6760","9180","2420","35.80","1921543","15472511970"
"900300","오가닉티코스메틱","348","330","-18","-5.17","22874183","7705795162"
"045060","오공","3655","3815","160","4.38","6277343","25532935545"
"080520","오디텍","5480","5650","170","3.10","1183246","6506653620"
"007310","오뚜기","433500","464500","31000","7.15","275842","124078068000"
"039830","오로라","7940","8750","810","10.20","480975","4005769930"
"322310","오로스테크놀로지","15150","14950","-200","-1.32","384345","5640984100"
"046120","오르비텍","6970","7380","410","5.88","69192557","490361895120"
"014940","오리엔탈정공","2805","3375","570","20.32","8307276","27564731885"
"002630","오리엔트바이오","760","835","75","9.87","8956794","7367506832"
"065500","오리엔트정공","1595","1905","310","19.44","2900617","5064862910"
"271560","오리온","106000","105000","-1000","-0.94","2955263","305238139000"
"001800","오리온홀딩스","14950","14850","-100","-0.67","1411000","21142884700"
"010470","오리콤","6850","6520","-330","-4.82","2179960","14071507710"
"352910","오비고","10950","11550","600","5.48","2730552","31439945150"
"053980","오상자이엘","6080","6610","530","8.72","22007680","165070506090"
"052420","오성첨단소재","2150","2150","0","0.00","0","0"
"241790","오션브릿지","11000","12500","1500","13.64","724227","8901434450"
"329020","오션스톤","1485","1300","-185","-12.46","19095","26965735"
"039200","오스코텍","28150","28350","200","0.71","3036513","86626038350"
"226400","오스테오닉","3025","2915","-110","-3.64","759157","2270082860"
"031510","오스템","1805","2005","200","11.08","16536393","35310067790"
"048260","오스템임플란트","99300","110500","11200","11.28","3797304","395338265350"
"138080","오이솔루션","22150","23700","1550","7.00","435956","10099808100"
"080580","오킨스전자","21450","20150","-1300","-6.06","1507559","30508201550"
"067170","오텍","7660","7450","-210","-2.74","1254192","9790239930"
"353590","오토앤","11550","13650","2100","18.18","10098366","132359015150"
"173130","오파스넷","6140","5520","-620","-10.10","9227341","51226249850"
"049480","오픈베이스","2825","3080","255","9.03","16896962","51769381745"
"309930","오하임아이엔티","3120","3600","480","15.38","8961290","31574280630"
"244460","올리패스","5800","5790","-10","-0.17","4706443","26970025330"
"226950","올릭스","23500","23050","-450","-1.91","2295179","52872121500"
"057540","옴니시스템","2635","2235","-400","-15.18","54377428","138949706460"
"131030","옵투스제약","6160","6640","480","7.79","939125","6413109840"
"082210","옵트론텍","5340","5630","290","5.43","5943939","33150123990"
"109080","옵티시스","11800","14000","2200","18.64","2186815","31463796250"
"153710","옵티팜","8620","9920","1300","15.08","6063649","60750094800"
"321820","와이더플래닛","7500","7930","430","5.73","318335","2463792280"
"122990","와이솔","8590","8990","400","4.66","855124","7467226460"
"232140","와이아이케이","4140","4285","145","3.50","1443696","6028036425"
"065530","와이어블","2680","2955","275","10.26","15238643","46221837355"
"067900","와이엔텍","9220","10100","880","9.54","2780644","28336719450"
"155650","와이엠씨","6210","6000","-210","-3.38","708676","4385549710"
"273640","와이엠텍","15000","16700","1700","11.33","645291","10220356000"
"251370","와이엠티","12600","15150","2550","20.24","3471498","50927797700"
"066430","와이오엠","2005","1885","-120","-5.99","1085114","2140738475"
"193250","와이제이엠게임즈","2100","2165","65","3.10","17425928","37837131220"
"273060","와이즈버즈","1290","1300","10","0.78","1715571","2255757295"
"019210","와이지-원","6650","7440","790","11.88","2276211","15605460290"
"122870","와이지엔터테인먼트","49650","59000","9350","18.83","4688451","256960169750"
"011690","와이투솔루션","800","710","-90","-11.25","24424670","17018410009"
"332570","와이팜","4660","4765","105","2.25","1359707","6480110840"
"079000","와토스코리아","5630","6560","930","16.52","4772283","31758334460"
"070960","용평리조트","4005","4050","45","1.12","1195458","4736983720"
"316140","우리금융지주","11600","12100","500","4.31","52073574","612219814214"
"032820","우리기술","2225","2090","-135","-6.07","62533937","130696604570"
"041190","우리기술투자","5530","6310","780","14.10","69381935","435045036800"
"115440","우리넷","8730","8980","250","2.86","1594496","14107138280"
"046970","우리로","1485","1605","120","8.08","9329031","14523867670"
"082850","우리바이오","3175","3790","615","19.37","86340580","350117591090"
"215360","우리산업","14700","16350","1650","11.22","4534819","73058411350"
"072470","우리산업홀딩스","4450","5580","1130","25.39","46780102","256700160950"
"073560","우리손에프앤지","1965","1990","25","1.27","16267619","31500097120"
"037400","우리엔터프라이즈","2310","2630","320","13.85","11488032","30148826195"
"153490","우리이앤엘","1195","1355","160","13.39","6833566","8999499220"
"010050","우리종금","884","973","89","10.07","56591014","52297769946"
"101170","우림피티에스","8950","9120","170","1.90","47627462","430632679790"
"006980","우성","24900","25100","200","0.80","176397","4315235250"
"066590","우수AMS","3810","4010","200","5.25","7053310","28420052605"
"017370","우신시스템","2470","2670","200","8.10","2398470","6288655345"
"103840","우양","3800","4015","215","5.66","1599171","6414925710"
"046940","우원개발","4305","5480","1175","27.29","18047182","88904591225"
"215380","우정바이오","4970","5070","100","2.01","2959385","15542091535"
"065680","우주일렉트로","21400","21500","100","0.47","893856","18817784300"
"105840","우진","11900","13650","1750","14.71","29867900","373950511400"
"018620","우진비앤지","2115","2175","60","2.84","20175172","42855767475"
"010400","우진아이엔에스","6020","6620","600","9.97","786964","5366242400"
"049800","우진플라임","3385","3895","510","15.07","700933","2537775385"
"016880","웅진","1395","1505","110","7.89","9734088","14416017970"
"095720","웅진씽크빅","2380","2590","210","8.82","4485171","11480040705"
"005820","원림","22800","25400","2600","11.40","94719","2408575600"
"307280","원바이오젠","1625","1645","20","1.23","1144919","1866306265"
"053080","원방테크","10550","12000","1450","13.74","1855121","21264950350"
"032940","원익","3675","3870","195","5.31","348810","1315136205"
"240810","원익IPS","28700","29350","650","2.26","8089181","242650464860"
"074600","원익QnC","26600","24850","-1750","-6.58","9792238","243587593050"
"104830","원익머트리얼즈","30850","31750","900","2.92","1887334","57708639400"
"014190","원익큐브","2460","2750","290","11.79","8701040","23624546965"
"131390","원익피앤이","20650","21050","400","1.94","2296690","48109796950"
"030530","원익홀딩스","3835","4000","165","4.30","3140193","12232381265"
"012620","원일특강","11500","12150","650","5.65","3637343","44485370700"
"382840","원준","41368","35650","-5718","-13.82","9254437","378301751800"
"336570","원텍","3025","2975","-50","-1.65","23672635","72520359345"
"376980","원티드랩","21900","23250","1350","6.16","2688364","64065927450"
"122830","원포유","1890","1955","65","3.44","313892","588984730"
"008370","원풍","4880","5040","160","3.28","345045","1709816705"
"008290","원풍물산","736","863","127","17.26","7829406","6898020313"
"101160","월덱스","18550","19000","450","2.43","2669612","50766563650"
"336060","웨이버스","1720","1745","25","1.45","6661895","11600937605"
"095270","웨이브일렉트로","5580","5440","-140","-2.51","863726","4671426680"
"010600","웰바이오텍","1650","1705","55","3.33","43941055","78757150995"
"065950","웰크론","3355","3590","235","7.00","10710777","39478539475"
"076080","웰크론한텍","2935","4420","1485","50.60","100605831","424548156745"
"196700","웹스","3440","3990","550","15.99","46198923","179951688205"
"069080","웹젠","18700","20800","2100","11.23","1422426","27837392900"
"053580","웹케시","16450","20250","3800","23.10","1084349","20189601550"
"071460","위니아","2790","2550","-240","-8.60","1818711","4677735270"
"377460","위니아에이드","11700","9160","-2540","-21.71","7368780","73944976260"
"044340","위닉스","12150","12950","800","6.58","640833","7870833550"
"330350","위더스제약","8530","8970","440","5.16","605752","5440727790"
"348350","위드텍","15300","15100","-200","-1.31","209353","3169100650"
"112040","위메이드","59100","71200","12100","20.47","21811663","1467621914200"
"101730","위메이드맥스","18150","22800","4650","25.62","23180045","488690119150"
"123420","위메이드플레이","23550","28100","4550","19.32","4578091","121902014750"
"065370","위세아이텍","11350","11200","-150","-1.32","400509","4568652100"
"140660","위월드","2400","2495","95","3.96","10413","24403000"
"038620","위즈코프","1130","1205","75","6.64","25593488","30712309415"
"299900","위지윅스튜디오","21750","25600","3850","17.70","9375036","221333006750"
"036090","위지트","839","1020","181","21.57","129189345","137013292152"
"136540","윈스","13600","14300","700","5.15","411852","5718193000"
"320000","윈텍","2125","2340","215","10.12","6336308","15184253280"
"097800","윈팩","1400","1460","60","4.29","1393871","1984943705"
"192390","윈하이텍","3615","4045","430","11.89","2078901","8016290900"
"313760","윌링스","11100","11700","600","5.41","1568355","17927607700"
"008600","윌비스","931","1005","74","7.95","7981201","7776369436"
"900340","윙입푸드","1365","1205","-160","-11.72","24648918","31673873475"
"033270","유나이티드제약","23550","25700","2150","9.13","1548052","39944241900"
"064510","유네코","2750","2750","0","0.00","0","0"
"014830","유니드","89000","96300","7300","8.20","1540801","146252880800"
"036200","유니셈","7360","7400","40","0.54","13643538","103125961020"
"018000","유니슨","2370","2800","430","18.14","22777388","58138438240"
"000910","유니온","5790","6400","610","10.54","25603157","165859440080"
"047400","유니온머티리얼","2230","3445","1215","54.48","273660398","905648797770"
"203450","유니온커뮤니티","2795","3260","465","16.64","4467675","14870664175"
"011330","유니켐","1200","1195","-5","-0.42","1851358","2196955710"
"077500","유니퀘스트","9000","9210","210","2.33","1757704","16317011970"
"011320","유니크","6520","7120","600","9.20","13252914","88967415620"
"086390","유니테스트","17850","19300","1450","8.12","3578360","65693094700"
"241690","유니테크노","5650","5860","210","3.72","2868110","16411703010"
"142210","유니트론텍","3695","4005","310","8.39","1595527","6104241355"
"121060","유니포인트","1700","1745","45","2.65","54690","95889485"
"048430","유라테크","6900","7370","470","6.81","437615","3185249080"
"206650","유바이오로직스","15750","17200","1450","9.21","9736939","164483785600"
"089850","유비벨록스","14650","16250","1600","10.92","2071426","33017481550"
"084440","유비온","2235","2295","60","2.68","135739","306649820"
"032620","유비케어","5360","6090","730","13.62","9936280","61622968590"
"264450","유비쿼스","14850","17400","2550","17.17","471009","7598455300"
"078070","유비쿼스홀딩스","16600","16350","-250","-1.51","1051821","17478108750"
"002920","유성기업","2820","2970","150","5.32","279511","807212985"
"024800","유성티엔에스","2555","2715","160","6.26","863082","2218235235"
"000700","유수홀딩스","5920","6130","210","3.55","391097","2346820600"
"054930","유신","27250","27550","300","1.10","4273501","114071671350"
"069330","유아이디","2060","2230","170","8.25","2078639","4575617310"
"049520","유아이엘","2550","3070","520","20.39","520875","1483780345"
"367460","유안타제7호스팩","2480","2180","-300","-12.10","8865673","21303886615"
"367480","유안타제8호스팩","2150","2150","0","0.00","493678","1064511235"
"003470","유안타증권","2675","2945","270","10.09","2345907","6480885000"
"003475","유안타증권우","2880","3235","355","12.33","90598","271998880"
"263770","유에스티","3025","3320","295","9.75","389935","1217642445"
"337840","유엑스엔","17400","19600","2200","12.64","58269","1058377250"
"072130","유엔젤","3180","3395","215","6.76","962831","3216780125"
"000220","유유제약","6470","6770","300","4.64","4748389","32788246360"
"000225","유유제약1우","8700","9420","720","8.28","1328804","12890575770"
"000227","유유제약2우B","17000","17250","250","1.47","22410","398754350"
"388720","유일로보틱스","21100","28400","7300","34.60","53281157","1438136024450"
"340930","유일에너테크","13250","15200","1950","14.72","1890454","28515685350"
"023410","유진기업","3905","4110","205","5.25","4118937","16138795290"
"056080","유진로봇","5020","5390","370","7.37","9046214","48016575455"
"373340","유진스팩6호","2265","2250","-15","-0.66","832091","1951605220"
"388800","유진스팩7호","2180","2155","-25","-1.15","189087","409599230"
"413630","유진스팩8호","2115","2120","5","0.24","199534","422941580"
"084370","유진테크","29650","28850","-800","-2.70","2642793","79064537038"
"001200","유진투자증권","2640","2935","295","11.17","3036057","8534685860"
"178780","유테크","1730","1730","0","0.00","0","0"
"221800","유투바이오","28750","29000","250","0.87","1698","43481400"
"179900","유티아이","17500","23000","5500","31.43","3374725","77171997200"
"263050","유틸렉스","6700","5240","-1460","-21.79","33042405","179672793260"
"000100","유한양행","57300","59100","1800","3.14","3081696","177593427900"
"000105","유한양행우","55200","56800","1600","2.90","9902","555724100"
"003460","유화증권","2340","2500","160","6.84","232688","552739530"
"003465","유화증권우","2535","2590","55","2.17","10556","27511205"
"191410","육일씨엔에쓰","3180","3455","275","8.65","692031","2369875975"
"008730","율촌화학","19000","26150","7150","37.63","2368711","50460526200"
"072770","율호","1385","1615","230","16.61","8941064","13365126975"
"008250","이건산업","8690","9500","810","9.32","978196","8648662340"
"039020","이건홀딩스","3910","3945","35","0.90","3840212","14622339355"
"025820","이구산업","2985","3325","340","11.39","4205122","13015519540"
"067920","이글루","5320","5700","380","7.14","1368826","7961023450"
"044960","이글벳","6200","6710","510","8.23","11522884","76768422010"
"303530","이노뎁","14600","14200","-400","-2.74","978343","14615005900"
"302430","이노메트리","9550","12000","2450","25.65","400945","4385624450"
"279060","이노벡스","4665","4860","195","4.18","65153","308853410"
"214320","이노션","45850","43300","-2550","-5.56","2665155","120272796050"
"056090","이노시스","2220","4535","2315","104.28","62725031","665785064980"
"073490","이노와이어리스","28000","29900","1900","6.79","860725","25101359150"
"215790","이노인스트루먼트","1665","1710","45","2.70","1644994","2735514715"
"344860","이노진","7000","7390","390","5.57","7996","56083140"
"246960","이노테라피","9150","9540","390","4.26","56680","528741280"
"088390","이녹스","21200","25200","4000","18.87","1772716","42866881850"
"272290","이녹스첨단소재","34050","33600","-450","-1.32","6861621","236312363650"
"053350","이니텍","3930","4195","265","6.74","2449370","10656951760"
"041520","이라이콤","5410","5810","400","7.39","481904","2670235730"
"264850","이랜시스","2925","3270","345","11.79","14969512","51099912995"
"054210","이랜텍","18950","19550","600","3.17","8805279","171085125900"
"164060","이루다","5320","5840","520","9.77","5980553","33553900125"
"065440","이루온","2410","3115","705","29.25","228939403","679221290575"
"088260","이리츠코크렙","5780","5820","40","0.69","1268712","7106641390"
"139480","이마트","106500","108500","2000","1.88","4558614","492807151350"
"115610","이미지스","2565","2620","55","2.14","2079093","5414001195"
"349720","이베스트스팩5호","2100","2105","5","0.24","115647","242657010"
"078020","이베스트투자증권","6470","6820","350","5.41","1127298","7409967000"
"131400","이브이첨단소재","1895","1800","-95","-5.01","40237876","76484032150"
"208850","이비테크","6060","5990","-70","-1.16","3226","17878630"
"351330","이삭엔지니어링","11100","11650","550","4.95","1048233","12155186950"
"080010","이상네트웍스","5490","5760","270","4.92","1194379","6629271450"
"379390","이성씨엔아이","12050","11800","-250","-2.07","328","3350550"
"086890","이수앱지스","8190","8260","70","0.85","14460989","124773882000"
"007660","이수페타시스","6870","6990","120","1.75","25481743","186232101300"
"005950","이수화학","14500","16200","1700","11.72","6644554","100986208450"
"015020","이스타코","1275","1500","225","17.65","39233239","57421313650"
"047560","이스트소프트","9680","9960","280","2.89","1075421","10621887170"
"900110","이스트아시아홀딩스","225","229","4","1.78","93086123","21194197247"
"067010","이씨에스","3870","4180","310","8.01","13987792","65586683515"
"093230","이아이디","1280","1505","225","17.58","29751401","43551669915"
"341310","이앤에치","1700","1695","-5","-0.29","48590","75624610"
"101360","이엔드디","23350","28300","4950","21.20","2084255","56145034900"
"102710","이엔에프테크놀로지","27650","29350","1700","6.15","1127683","32130913100"
"066980","이엔코퍼레이션","2915","3240","325","11.15","6697735","21191155355"
"074610","이엔플러스","3075","3160","85","2.76","13027870","42399080625"
"063760","이엘피","5340","5330","-10","-0.19","990037","5366446480"
"123570","이엠넷","5340","6180","840","15.73","1620088","9258831490"
"083470","이엠앤아이","3220","3220","0","0.00","0","0"
"095190","이엠코리아","2855","3380","525","18.39","4296120","13446869725"
"091120","이엠텍","27150","27000","-150","-0.55","1389132","39067841800"
"232530","이엠티","3050","4480","1430","46.89","59481","154934820"
"102460","이연제약","23250","27450","4200","18.06","8365874","228313324650"
"039030","이오테크닉스","77800","78400","600","0.77","1598939","123957180700"
"294090","이오플로우","19350","20600","1250","6.46","1627189","32166023000"
"088290","이원컴포텍","8640","9100","460","5.32","2753139","23684458610"
"084680","이월드","1795","1995","200","11.14","33957656","69477467720"
"181340","이즈미디어","2705","2705","0","0.00","0","0"
"353810","이지바이오","4350","4545","195","4.48","26453551","122729806035"
"350520","이지스레지던스리츠","4870","4660","-210","-4.31","1399811","6398893070"
"334890","이지스밸류리츠","5140","5040","-100","-1.95","1346339","6651661410"
"099750","이지케어텍","24500","25000","500","2.04","413457","10580003250"
"377330","이지트로닉스","13350","15550","2200","16.48","8020022","123319580750"
"035810","이지홀딩스","3650","3665","15","0.41","15761818","57158368605"
"160600","이큐셀","3100","3100","0","0.00","0","0"
"092130","이크레더블","17100","17200","100","0.58","154480","2619265800"
"096040","이트론","183","201","18","9.84","278051316","54198257509"
"134060","이퓨쳐","6480","6460","-20","-0.31","340942","2297862530"
"001840","이화공영","5880","6610","730","12.41","9670103","62992229690"
"000760","이화산업","15000","15950","950","6.33","23088","358373550"
"024810","이화전기","1130","961","-169","-14.96","63133509","62359818756"
"014990","인디에프","780","778","-2","-0.26","1029238","786594833"
"041830","인바디","23100","25850","2750","11.90","679336","16804540450"
"352940","인바이오","5300","6000","700","13.21","612297","3564788680"
"101140","인바이오젠","1830","2195","365","19.95","18483657","42936914280"
"216400","인바이츠바이오코아","8800","8900","100","1.14","6886","60962280"
"079950","인베니아","2005","2090","85","4.24","1804736","3817690220"
"277410","인산가","2010","2150","140","6.97","2361677","4907816760"
"060150","인선이엔티","8490","9680","1190","14.02","14093435","137878518590"
"033230","인성정보","2185","2345","160","7.32","24834072","60573056770"
"006490","인스코비","2195","2100","-95","-4.33","11944987","25472878840"
"037330","인지디스플레","1830","2010","180","9.84","981287","1873153320"
"023800","인지컨트롤스","7260","8250","990","13.64","1918369","15473148750"
"034590","인천도시가스","25000","27650","2650","10.60","1095027","31552320850"
"211050","인카금융서비스","7950","7640","-310","-3.90","2141978","15554642510"
"083640","인콘","1055","1335","280","26.54","207862529","327208386139"
"216050","인크로스","17700","16400","-1300","-7.34","1653981","26235170700"
"049070","인탑스","28000","31750","3750","13.39","9619218","296929642300"
"119610","인터로조","26750","28850","2100","7.85","1283990","36315629050"
"017250","인터엠","1210","1290","80","6.61","1443976","1864025110"
"129260","인터지스","2810","3025","215","7.65","1773199","5085924110"
"051370","인터플렉스","12700","12700","0","0.00","2063297","26580867450"
"064290","인텍플러스","19200","18400","-800","-4.17","2804229","52834571400"
"189300","인텔리안테크","62600","69700","7100","11.34","970866","63739060400"
"150840","인트로메딕","5850","5850","0","0.00","0","0"
"048530","인트론바이오","10450","12600","2150","20.57","8583135","97387000300"
"023810","인팩","8580","8900","320","3.73","473332","4210161320"
"175140","인포마크","7040","6970","-70","-0.99","278595","2020401210"
"115310","인포바인","30300","37400","7100","23.43","8858458","324316260000"
"039290","인포뱅크","13750","14900","1150","8.36","5204340","75885920250"
"071200","인피니트헬스케어","5110","5960","850","16.63","7556465","45819448360"
"101930","인화정공","13750","14950","1200","8.73","577902","8064924650"
"249420","일동제약","33200","40050","6850","20.63","107153436","4662000352700"
"000230","일동홀딩스","25850","32050","6200","23.98","35485028","1113762180850"
"013360","일성건설","3590","4120","530","14.76","31712142","124626083955"
"003120","일성신약","77000","77300","300","0.39","11170","866297300"
"333430","일승","3240","3995","755","23.30","33832272","124933391505"
"068330","일신바이오","3430","3430","0","0.00","0","0"
"003200","일신방직","95500","105500","10000","10.47","108102","10923306900"
"007110","일신석재","1400","1565","165","11.79","10789698","16073128040"
"058450","일야","604","654","50","8.28","6474604","4049306196"
"007570","일양약품","23250","23950","700","3.01","1888255","45627830200"
"007575","일양약품우","25650","25550","-100","-0.39","34445","910542250"
"008500","일정실업","18400","24100","5700","30.98","154487","3359023600"
"019540","일지테크","2475","2785","310","12.53","526688","1363881875"
"081000","일진다이아","19300","22850","3550","18.39","654739","13495118750"
"020760","일진디스플","2135","2000","-135","-6.32","17884728","39372020350"
"020150","일진머티리얼즈","69300","75600","6300","9.09","5952383","428260094700"
"103590","일진전기","6950","5960","-990","-14.24","18309484","120702619470"
"094820","일진파워","16700","19150","2450","14.67","9671331","167273134000"
"271940","일진하이솔루스","32000","37650","5650","17.66","1643304","55680182750"
"015860","일진홀딩스","6250","6140","-110","-1.76","30872557","205903105510"
"226320","잇츠한불","16250","16650","400","2.46","613501","9957715450"
"950140","잉글우드랩","4810","4780","-30","-0.62","4653923","24115904535"
"049550","잉크테크","6780","6830","50","0.74","308641","2076183010"
"254120","자비스","1795","1870","75","4.18","8210055","15483519255"
"043910","자연과환경","1445","1750","305","21.11","138386661","220262674920"
"234920","자이글","2910","2800","-110","-3.78","260381","708547970"
"289220","자이언트스텝","22950","27500","4550","19.83","11990895","322125263950"
"317400","자이에스앤디","5940","8000","2060","34.68","21937502","181375260090"
"033240","자화전자","23900","24350","450","1.88","6316026","161149198450"
"174880","장원테크","1650","1655","5","0.30","1156096","1937980885"
"049630","재영솔루텍","698","786","88","12.61","4358183","3353065322"
"000950","전방","55500","54100","-1400","-2.52","27213","1512621300"
"110020","전진바이오팜","4480","4020","-460","-10.27","415033","1832175455"
"208140","정다운","2285","2405","120","5.25","3180815","7457637480"
"040420","정상제이엘에스","7460","7600","140","1.88","254617","1904102760"
"045510","정원엔시스","1965","2235","270","13.74","141331614","321306910615"
"217190","제너셈","6230","6240","10","0.16","359921","2225537700"
"095700","제넥신","32900","33550","650","1.98","2487181","82429139200"
"072520","제넨바이오","2290","2200","-90","-3.93","13280551","33648126955"
"122310","제노레이","8070","8860","790","9.79","1863460","16675095030"
"361390","제노코","21400","26350","4950","23.13","3505778","84350977350"
"066830","제노텍","3595","3000","-595","-16.55","11562","35839725"
"187420","제노포커스","5570","6610","1040","18.67","26839326","200018746950"
"225220","제놀루션","12350","12650","300","2.43","5429310","75800162350"
"123330","제닉","3970","5080","1110","27.96","19204554","103694154040"
"159580","제로투세븐","6890","7240","350","5.08","3190755","22476046490"
"147830","제룡산업","2990","3135","145","4.85","1892812","5685680315"
"033100","제룡전기","6980","7360","380","5.44","14595323","107742888650"
"079370","제우스","22900","22750","-150","-0.66","3023852","70679100800"
"054950","제이브이엠","17000","21650","4650","27.35","3366167","66799602050"
"023440","제이스코홀딩스","2350","2000","-350","-14.89","3493492","7819508135"
"090470","제이스텍","5720","6820","1100","19.23","2930847","19326759080"
"287410","제이시스메디칼","7340","7930","590","8.04","9550774","73223359280"
"137950","제이씨케미칼","7820","8580","760","9.72","16148138","139784524160"
"033320","제이씨현시스템","4905","5270","365","7.44","1522835","8010058440"
"348950","제이알글로벌리츠","4505","4685","180","4.00","16019396","72145927105"
"204270","제이앤티씨","5040","5190","150","2.98","389561","2017892340"
"194370","제이에스코퍼레이션","17500","17350","-150","-0.86","1645284","28146316700"
"026040","제이에스티나","2995","3055","60","2.00","840519","2449812010"
"126880","제이엔케이히터","5530","6090","560","10.13","7929657","46520345910"
"322510","제이엘케이","4695","5100","405","8.63","414398","2028014375"
"254160","제이엠멀티","5490","4370","-1120","-20.40","10510","45596420"
"033050","제이엠아이","1100","1160","60","5.45","2611771","2946012065"
"094970","제이엠티","3310","3630","320","9.67","1757920","6129967060"
"058420","제이웨이","2160","2160","0","0.00","0","0"
"025620","제이준코스메틱","972","906","-66","-6.79","10046045","9695227160"
"089790","제이티","6660","7070","410","6.16","2300560","16760414970"
"030000","제일기획","23550","22400","-1150","-4.88","6981502","156428577948"
"052670","제일바이오","1875","1875","0","0.00","1429386","2643344910"
"271980","제일약품","21150","23000","1850","8.75","2216716","54827876500"
"001560","제일연마","9060","9300","240","2.65","854499","7891992030"
"199820","제일전기공업","11950","12400","450","3.77","276430","3272064450"
"038010","제일테크노스","7070","7860","790","11.17","3715179","26318974750"
"002620","제일파마홀딩스","12050","13350","1300","10.79","625184","8428164100"
"276730","제주맥주","2170","2425","255","11.75","28248758","68097749875"
"080220","제주반도체","4210","4845","635","15.08","40985395","198354314365"
"006220","제주은행","4395","5330","935","21.27","27884264","166394566225"
"089590","제주항공","15700","15400","-300","-1.91","4330700","65403344091"
"216080","제테마","13800","15700","1900","13.77","501795","7431687350"
"229000","젠큐릭스","9280","9760","480","5.17","590719","5771046060"
"248020","젬","2500","2500","0","0.00","0","0"
"082270","젬백스","13050","15250","2200","16.86","3034951","41942593800"
"064800","젬백스링크","1310","1390","80","6.11","8275461","11321670300"
"044060","조광ILI","2441","1580","-861","-35.27","157436918","530782593940"
"004910","조광페인트","6100","8050","1950","31.97","1716048","12263229350"
"004700","조광피혁","42800","44700","1900","4.44","12833","559494200"
"001550","조비","19500","20850","1350","6.92","810009","15863862500"
"000480","조선내화","79400","77600","-1800","-2.27","22639","1755853600"
"120030","조선선재","152500","161000","8500","5.57","3623919","578021398000"
"034940","조아제약","2875","2945","70","2.43","3203083","9601850035"
"067000","조이시티","4770","5150","380","7.97","34153588","179990092025"
"018470","조일알미늄","1615","2225","610","37.77","205391869","446203990020"
"002600","조흥","174000","183000","9000","5.17","1282","226772500"
"185750","종근당","88800","91100","2300","2.59","405937","36708698400"
"063160","종근당바이오","28800","30450","1650","5.73","539516","16424447100"
"001630","종근당홀딩스","56400","61000","4600","8.16","86159","5053150000"
"033340","좋은사람들","1055","1055","0","0.00","0","0"
"036930","주성엔지니어링","16650","15900","-750","-4.50","20782952","344445846150"
"044380","주연테크","818","890","72","8.80","3797518","3321861170"
"239340","줌인터넷","4005","4305","300","7.49","13060535","57362698900"
"051980","중앙디앤엠","712","695","-17","-2.39","5335378","3907178986"
"072020","중앙백신","12150","12700","550","4.53","337025","4245537600"
"000440","중앙에너비스","21550","21350","-200","-0.93","1554481","33167709300"
"078650","지나인제약","2120","2120","0","0.00","0","0"
"228760","지노믹트리","13350","13150","-200","-1.50","2518899","33991850100"
"314130","지놈앤컴퍼니","18000","21400","3400","18.89","2456021","50723984550"
"013890","지누스","50200","47600","-2600","-5.18","1087329","51496906400"
"389030","지니너스","4103","2960","-1143","-27.86","23548603","110587712950"
"043610","지니뮤직","4100","4475","375","9.15","30059977","147685541265"
"263860","지니언스","7950","9050","1100","13.84","592853","5136256000"
"303030","지니틱스","2320","2640","320","13.79","18523170","47876360010"
"036180","지더블유바이텍","782","881","99","12.66","125237152","143809899946"
"208350","지란지교시큐리티","3835","3930","95","2.48","183532","709913240"
"144510","지씨셀","59200","65800","6600","11.15","2709133","174784304200"
"382480","지아이텍","3005","3440","435","14.48","8923302","28982556515"
"382800","지앤비에스엔지니어링","11650","12050","400","3.43","669138","8088408700"
"299480","지앤이헬스케어","899","896","-3","-0.33","1331","1164102"
"051160","지어소프트","12200","12700","500","4.10","1406836","17078791100"
"053050","지에스이","4565","5290","725","15.88","95767876","493855278850"
"119850","지엔씨에너지","4320","4535","215","4.98","14423303","66694822845"
"270520","지엔원에너지","2565","2730","165","6.43","11839274","32907767030"
"065060","지엔코","567","571","4","0.71","2454558","1394144644"
"204840","지엘팜텍","896","959","63","7.03","10627028","10419955216"
"013870","지엠비코리아","5480","5900","420","7.66","642940","3596908020"
"071320","지역난방공사","31100","33200","2100","6.75","42283","1349703350"
"311320","지오엘리먼트","18200","20150","1950","10.71","2212652","44840128450"
"035000","지투알","5800","6000","200","3.45","152195","909174970"
"388050","지투파워","7388","15500","8112","109.80","26504908","1179777644400"
"219750","지티지웰니스","1425","1425","0","0.00","0","0"
"088790","진도","2920","3350","430","14.73","1081151","3505707395"
"018120","진로발효","23550","24150","600","2.55","112807","2716703700"
"109820","진매트릭스","7830","7680","-150","-1.92","70217513","621738496900"
"086060","진바이오텍","4825","4880","55","1.14","1197841","5784470230"
"036890","진성티이씨","10200","10350","150","1.47","4523051","46925842340"
"363250","진시스템","10150","9800","-350","-3.45","528836","5448070450"
"003780","진양산업","7340","7690","350","4.77","1352208","10096671330"
"007370","진양제약","5990","6140","150","2.50","484977","3009451770"
"010640","진양폴리","5760","6340","580","10.07","1662960","10093037310"
"100250","진양홀딩스","3635","3575","-60","-1.65","857843","3064120730"
"051630","진양화학","3800","4030","230","6.05","772940","2944392390"
"272450","진에어","14550","14750","200","1.37","4243743","60134834350"
"011000","진원생명과학","11150","13200","2050","18.39","70983378","1029427279300"
"250030","진코스텍","4250","4395","145","3.41","25453","102904630"
"002780","진흥기업","1695","1815","120","7.08","23667237","40457110795"
"002787","진흥기업2우B","14900","14900","0","0.00","13517","194553300"
"002785","진흥기업우B","5430","5610","180","3.31","28350","151565130"
"233990","질경이","799","689","-110","-13.77","81968","56912881"
"085660","차바이오텍","15000","16850","1850","12.33","5163983","81712928700"
"261780","차백신연구소","6390","7550","1160","18.15","74670241","595844929100"
"009310","참엔지니어링","837","854","17","2.03","2907117","2409434968"
"158310","참존글로벌","1680","1680","0","0.00","0","0"
"094850","참좋은여행","9700","10100","400","4.12","1275158","12262179830"
"004650","창해에탄올","12000","12850","850","7.08","1808473","22986777700"
"278280","천보","216100","253900","37800","17.49","1202752","281366497900"
"000650","천일고속","63400","66000","2600","4.10","6010","390645600"
"140290","청광건설","592","597","5","0.84","5598","3017261"
"362320","청담글로벌","9150","10700","1550","16.94","90407743","932126522610"
"066360","체리부로","1180","1205","25","2.12","512342","604857060"
"033250","체시스","1030","1095","65","6.31","3025430","3151599852"
"047820","초록뱀미디어","15500","17150","1650","10.65","2868849","46763873800"
"052300","초록뱀컴퍼니","820","890","70","8.54","104749082","102950365771"
"118000","초록뱀헬스케어","974","940","-34","-3.49","13568653","13654881601"
"094360","칩스앤미디어","15400","19000","3600","23.38","2758409","47517453500"
"016790","카나리아바이오","35000","34700","-300","-0.86","42959163","1753688135800"
"016920","카스","2320","2460","140","6.03","34088404","88801880305"
"284620","카이노스메드","9353","7210","-2143","-22.91","2693880","21655373080"
"035720","카카오","71800","83500","11700","16.30","38897407","2943046366076"
"293490","카카오게임즈","49000","60200","11200","22.86","22821958","1241409163500"
"323410","카카오뱅크","31300","32150","850","2.72","31419737","981594678600"
"377300","카카오페이","65300","74100","8800","13.48","11661706","794854431500"
"042000","카페24","12500","13400","900","7.20","1461777","18833067200"
"006380","카프로","2880","3020","140","4.86","1648499","4741701700"
"317530","캐리소프트","6360","6370","10","0.16","1957003","14441306830"
"071850","캐스텍코리아","1920","2130","210","10.94","558077","1114675185"
"050110","캠시스","2300","2700","400","17.39","426640951","1117054770500"
"223310","커머스마이너","3320","3320","0","0.00","0","0"
"109070","컨버즈","4100","4100","0","0.00","0","0"
"900310","컬러레이","1010","1050","40","3.96","5864578","5882599622"
"078340","컴투스","75100","86600","11500","15.31","3530180","281701681400"
"063080","컴투스홀딩스","53600","63400","9800","18.28","5202141","309084196300"
"307930","컴퍼니케이","6050","6420","370","6.12","1065947","6737832580"
"079190","케스피온","1275","1375","100","7.84","4337980","5813496825"
"263700","케어랩스","6220","6690","470","7.56","4020428","28355459440"
"214370","케어젠","99600","144000","44400","44.58","2197300","277591382600"
"221980","케이디켐","14250","14700","450","3.16","1264582","19476678000"
"001620","케이비아이동국실업","603","667","64","10.61","1816299","1166894529"
"342550","케이비제20호스팩","2290","2290","0","0.00","0","0"
"424140","케이비제21호스팩","2105","2110","5","0.24","604308","1274544795"
"192250","케이사인","1760","2045","285","16.19","49787522","101132053695"
"029460","케이씨","20000","18000","-2000","-10.00","659856","12434505250"
"115500","케이씨에스","6270","6810","540","8.61","11073451","77795753480"
"281820","케이씨텍","17900","16450","-1450","-8.10","593860","10248040600"
"089150","케이씨티","5550","5730","180","3.24","5689999","32521296850"
"025880","케이씨피드","3795","3520","-275","-7.25","6413559","22696718405"
"093320","케이아이엔엑스","50000","57300","7300","14.60","253878","13847669450"
"073010","케이에스피","2160","2115","-45","-2.08","1513550","3132440345"
"105330","케이엔더블유","9170","10850","1680","18.32","778917","7779415140"
"272110","케이엔제이","11400","11000","-400","-3.51","378225","4189718200"
"039420","케이엘넷","2830","3005","175","6.18","5382833","16619979925"
"083550","케이엠","6410","7340","930","14.51","9621580","75769968750"
"032500","케이엠더블유","27150","31800","4650","17.13","3127516","96470233300"
"225430","케이엠제약","1570","1710","140","8.92","4266362","7564041670"
"102370","케이옥션","12300","7240","-5060","-41.14","24644296","225016333940"
"381970","케이카","20000","22650","2650","13.25","11557323","251057728800"
"145270","케이탑리츠","1075","1135","60","5.58","2725961","2898418145"
"036030","케이티알파","5290","6560","1270","24.01","31327008","209382983790"
"064820","케이프","4195","4775","580","13.83","8372138","41376173775"
"347140","케이프이에스제4호","2120","2100","-20","-0.94","81904","172205975"
"256940","케이피에스","5710","6300","590","10.33","679561","4252011140"
"024880","케이피에프","7130","9420","2290","32.12","73334111","625700090190"
"042040","케이피엠테크","582","549","-33","-5.67","32864417","18312296838"
"054410","케이피티유","5750","6030","280","4.87","189541","1119235360"
"258610","케일럼","4670","4340","-330","-7.07","1559023","6578431650"
"274090","켄코아에어로스페이스","10700","11500","800","7.48","1182514","13311846050"
"402420","켈스","14950","14800","-150","-1.00","1364","18965200"
"217600","켐온","2765","2890","125","4.52","81291624","246939634340"
"089010","켐트로닉스","19000","21650","2650","13.95","998493","20433403150"
"220260","켐트로스","6940","10100","3160","45.53","36314679","344413319480"
"176590","코나솔","5340","6190","850","15.92","72780","445938750"
"052400","코나아이","17000","18000","1000","5.88","1268138","22011195400"
"402030","코난테크놀로지","35500","25950","-9550","-26.90","8505670","260653973350"
"391710","코닉오토메이션","2690","4395","1705","63.38","45509680","169275787065"
"046070","코다코","1270","1305","35","2.76","1870192","2457491225"
"047770","코데즈컴바인","1860","2300","440","23.66","123780035","301272204230"
"078940","코드네이처","1665","1465","-200","-12.01","1728859","2586941215"
"080530","코디","1400","1550","150","10.71","1358320","2110446810"
"224060","코디엠","865","863","-2","-0.23","14764724","3034595598"
"417310","코람코더원리츠","5470","5410","-60","-1.10","847825","4430516350"
"357120","코람코에너지리츠","5800","5550","-250","-4.31","2583680","14238428250"
"104540","코렌텍","10350","10700","350","3.38","875526","8958117900"
"027050","코리아나","2950","3020","70","2.37","2214337","6590690325"
"290510","코리아센터","5040","5590","550","10.91","3960306","21092725170"
"007815","코리아써우","8010","8100","90","1.12","52057","424897050"
"007810","코리아써키트","19200","18650","-550","-2.86","5294478","105189370450"
"00781K","코리아써키트2우B","8550","8600","50","0.58","9785","83756180"
"190650","코리아에셋투자증권","9650","9930","280","2.90","2308903","24451978320"
"101670","코리아에스이","2055","2260","205","9.98","5563244","12109652320"
"123410","코리아에프티","2795","2915","120","4.29","4126051","11776000610"
"003690","코리안리","8510","8670","160","1.88","2619766","22893763920"
"036690","코맥스","3515","3785","270","7.68","648961","2344219245"
"049430","코메론","8920","9440","520","5.83","425306","3935599150"
"183300","코미코","47600","46000","-1600","-3.36","773603","36782135500"
"041960","코미팜","7190","7940","750","10.43","1938171","14042508750"
"089890","코세스","8620","10100","1480","17.17","4525607","44913608080"
"009730","코센","2715","2715","0","0.00","0","0"
"189350","코셋","2245","2185","-60","-2.67","4642","8602665"
"082660","코스나인","965","996","31","3.21","11713839","12097410350"
"192820","코스맥스","61700","67300","5600","9.08","2151909","146222661250"
"044820","코스맥스비티아이","9710","9430","-280","-2.88","551616","5163109660"
"222040","코스맥스엔비티","4480","5020","540","12.05","1589811","7639137490"
"241710","코스메카코리아","9730","9740","10","0.10","411222","4003023850"
"005070","코스모신소재","49650","62100","12450","25.08","18096133","1006419816000"
"005420","코스모화학","14650","22250","7600","51.88","49826921","937666742700"
"069110","코스온","2630","2630","0","0.00","0","0"
"169670","코스텍시스템","9600","11500","1900","19.79","126017","1369505150"
"071950","코아스","995","994","-1","-0.10","1426187","1381763092"
"166480","코아스템","10800","11100","300","2.78","605790","7030028600"
"045970","코아시아","6350","7380","1030","16.22","4374939","31626492550"
"196450","코아시아옵틱스","2000","1910","-90","-4.50","3130092","5952124375"
"029960","코엔텍","8210","8690","480","5.85","7590409","66938434800"
"002020","코오롱","22850","25700","2850","12.47","598471","14637968650"
"003070","코오롱글로벌","15800","18600","2800","17.72","3309407","63675035250"
"003075","코오롱글로벌우","27950","30350","2400","8.59","114138","3736496100"
"102940","코오롱생명과학","32800","39950","7150","21.80","880709","32731678450"
"002025","코오롱우","16100","17000","900","5.59","778587","15315083550"
"120110","코오롱인더","51700","54500","2800","5.42","2953307","154567612950"
"120115","코오롱인더우","27050","28600","1550","5.73","110108","3090721400"
"950160","코오롱티슈진","8010","8010","0","0.00","0","0"
"138490","코오롱플라스틱","10550","11900","1350","12.80","5629131","63310766380"
"056000","코원플레이","2860","2860","0","0.00","0","0"
"021240","코웨이","64900","64600","-300","-0.46","2417225","154788348500"
"033290","코웰패션","6200","6730","530","8.55","2533317","16337816080"
"056360","코위버","7010","7300","290","4.14","711857","4973093950"
"282880","코윈테크","24400","28550","4150","17.01","1411647","38002525350"
"121850","코이즈","3130","3870","740","23.64","42934426","160489286560"
"015710","코콤","4955","5180","225","4.54","337962","1718283965"
"052330","코텍","8620","9690","1070","12.41","1285927","12083076390"
"322780","코퍼스코리아","2365","2745","380","16.07","33044919","88962217890"
"126600","코프라","6420","6450","30","0.47","16566046","114074082670"
"036420","콘텐트리중앙","35750","41450","5700","15.94","3521795","131906601550"
"200130","콜마비앤에이치","26700","27700","1000","3.75","1341942","36134273950"
"031820","콤텍시스템","770","862","92","11.95","9853966","7940679649"
"294570","쿠콘","32800","35050","2250","6.86","897195","30043930850"
"192400","쿠쿠홀딩스","15900","17000","1100","6.92","872577","14382930950"
"284740","쿠쿠홈시스","28150","31200","3050","10.83","381378","11380727250"
"317690","퀀타매트릭스","6010","6570","560","9.32","2822768","18989652070"
"365270","큐라클","19200","17750","-1450","-7.55","4324018","81049850950"
"060280","큐렉소","7430","8070","640","8.61","1173938","9322177500"
"015590","큐로","390","410","20","5.13","5437386","2204852478"
"040350","큐로컴","1105","1115","10","0.90","7046026","8316515190"
"051780","큐로홀딩스","500","501","1","0.20","4929781","2470969832"
"115180","큐리언트","30300","30300","0","0.00","0","0"
"182360","큐브엔터","13150","13750","600","4.56","1982929","27479629450"
"066310","큐에스아이","12100","12700","600","4.96","2501949","31016317350"
"136660","큐엠씨","2060","2590","530","25.73","9132","19006200"
"016600","큐캐피탈","567","555","-12","-2.12","22785154","12682576154"
"264900","크라운제과","8600","9770","1170","13.60","5001405","51953471210"
"26490K","크라운제과우","11000","12300","1300","11.82","1035094","13609977500"
"005740","크라운해태홀딩스","7110","7500","390","5.49","3536337","30067199400"
"005745","크라운해태홀딩스우","11450","11700","250","2.18","129854","1631528950"
"259960","크래프톤","237000","259500","22500","9.49","3966456","976776694000"
"096240","크레버스","23850","24300","450","1.89","426056","10473374850"
"215570","크로넥스","3200","2750","-450","-14.06","74295","198304770"
"043590","크로바하이텍","1515","1790","275","18.15","7232536","11708637855"
"114120","크루셜텍","1085","1085","0","0.00","0","0"
"110790","크리스에프앤씨","35500","35100","-400","-1.13","587638","20416612550"
"900250","크리스탈신소재","988","1145","157","15.89","80489018","90956644594"
"083790","크리스탈지노믹스","4190","4065","-125","-2.98","3420696","14303743195"
"045520","크린앤사이언스","10150","10300","150","1.48","210113","2209727650"
"036170","클라우드에어","1095","1240","145","13.24","14299135","18090131625"
"214150","클래시스","14500","15600","1100","7.59","6492415","102174617350"
"352770","클리노믹스","7700","8320","620","8.05","2811907","25348866100"
"237880","클리오","14400","14800","400","2.78","1209214","17438258200"
"139670","키네마스터","9290","11000","1710","18.41","5042425","58434951920"
"020120","키다리스튜디오","8260","10100","1840","22.28","28718192","290671215190"
"413600","키움제6호스팩","2275","2175","-100","-4.40","1339309","3001366455"
"039490","키움증권","79600","89600","10000","12.56","1557077","123529985000"
"054780","키이스트","7660","8680","1020","13.32","1187158","9836432900"
"336040","타스컴","19700","18600","-1100","-5.58","2262","42064700"
"219130","타이거일렉","16200","15800","-400","-2.47","727024","11455365550"
"318660","타임기술","2295","1740","-555","-24.18","54480","84223895"
"180060","탑선","13150","12400","-750","-5.70","132195","1626843100"
"065130","탑엔지니어링","5600","6100","500","8.93","441781","2691144790"
"134580","탑코미디어","7350","8810","1460","19.86","1675139","13617052220"
"014580","태경비케이","4125","4520","395","9.58","2669914","11345353590"
"015890","태경산업","6180","6640","460","7.44","7290461","49025245680"
"006890","태경케미컬","14350","13350","-1000","-6.97","6392219","91937561750"
"023160","태광","13050","16600","3550","27.20","10478000","152613143450"
"003240","태광산업","906000","887000","-19000","-2.10","6850","6102956000"
"011280","태림포장","3105","3340","235","7.57","2346698","7799693480"
"323280","태성","1890","1725","-165","-8.73","10692552","19271495895"
"053620","태양","8290","9060","770","9.29","1132783","10080102980"
"004100","태양금속","1415","1385","-30","-2.12","3803163","5207482160"
"004105","태양금속우","2525","2520","-5","-0.20","145020","360062310"
"116100","태양기계","1005","1000","-5","-0.50","15625","15003690"
"009410","태영건설","6760","7110","350","5.18","3654531","25623447640"
"009415","태영건설우","9700","11900","2200","22.68","1872363","22396324270"
"044490","태웅","9930","11250","1320","13.29","1459227","14795467550"
"124560","태웅로직스","5460","5170","-290","-5.31","11859738","60673714020"
"001420","태원물산","4950","5020","70","1.41","236791","1192725740"
"007980","태평양물산","1845","1810","-35","-1.90","1980153","3488203810"
"191420","테고사이언스","21700","20900","-800","-3.69","380875","8102731100"
"073640","테라사이언스","1855","1725","-130","-7.01","9515675","16901415840"
"182690","테라셈","1440","1440","0","0.00","0","0"
"066700","테라젠이텍스","4455","4865","410","9.20","5950675","29004886660"
"095610","테스","20000","20350","350","1.75","1929204","38902102700"
"055490","테이팩스","68600","80400","11800","17.20","466119","34317006000"
"308700","테크엔","726","695","-31","-4.27","6718","4170539"
"089030","테크윙","7544","8160","616","8.17","9402014","139730650190"
"258050","테크트랜스","1185","1200","15","1.27","30924","34857800"
"054450","텔레칩스","14400","15500","1100","7.64","4146895","64161860400"
"091440","텔레필드","4130","3935","-195","-4.72","1315999","5292067935"
"078000","텔코웨어","9470","9850","380","4.01","60552","581673520"
"200230","텔콘RF제약","1540","1505","-35","-2.27","7522969","11535407240"
"214420","토니모리","4220","4155","-65","-1.54","2608953","11059387570"
"393210","토마토시스템","11850","10700","-1150","-9.70","5588","61575130"
"215480","토박스코리아","4610","4945","335","7.27","743011","3530580145"
"051360","토비스","9100","9270","170","1.87","1661754","15210173850"
"045340","토탈소프트","6140","6380","240","3.91","11436750","77753505220"
"108230","톱텍","7240","7780","540","7.46","1108399","8197174390"
"079970","투비소프트","1080","971","-109","-10.09","4181440","4137144556"
"199800","툴젠","70500","68400","-2100","-2.98","644498","44872442500"
"105550","트루윈","2580","2755","175","6.78","28612283","84367344810"
"290090","트윔","16400","19150","2750","16.77","1121626","20756496550"
"026150","특수건설","8650","11450","2800","32.37","12866627","137676119510"
"322180","티라유텍","8810","9190","380","4.31","217968","1988270990"
"117730","티로보틱스","7090","7980","890","12.55","12303465","96593846020"
"033830","티비씨","989","1085","96","9.71","10909217","11407720059"
"057680","티사이언티픽","2415","3195","780","32.30","49783306","159886197530"
"064760","티씨케이","113700","117700","4000","3.52","680322","81722496950"
"246710","티앤알바이오팹","15500","20050","4550","29.35","7440047","143951680900"
"340570","티앤엘","33700","37400","3700","10.98","1542368","55282712250"
"043220","티에스넥스젠","1130","1185","55","4.87","10058834","11758510440"
"277880","티에스아이","9580","10500","920","9.60","1509563","15126505360"
"131290","티에스이","60700","58400","-2300","-3.79","3107498","187603837000"
"019180","티에이치엔","3040","3290","250","8.22","1144153","3613008755"
"356860","티엘비","37150","40900","3750","10.09","1428709","56559871000"
"062860","티엘아이","7000","7060","60","0.86","254562","1759256940"
"363280","티와이홀딩스","18400","18950","550","2.99","1197674","21901650450"
"36328K","티와이홀딩스우","16450","18350","1900","11.55","55428","928853600"
"321550","티움바이오","16350","16900","550","3.36","1628850","28625075450"
"091810","티웨이항공","1990","2025","35","1.76","8735772","17428909770"
"004870","티웨이홀딩스","545","541","-4","-0.73","4778123","2547312574"
"104480","티케이케미칼","4060","4440","380","9.36","8825757","36649446965"
"081150","티플랙스","4290","4825","535","12.47","40763295","192568287715"
"130740","티피씨글로벌","2900","3200","300","10.34","2754199","8592985770"
"217880","틸론","11000","12800","1800","16.36","31255","350068740"
"084730","팅크웨어","13750","16950","3200","23.27","4280038","67956669850"
"046210","파나진","3105","3000","-105","-3.38","982963","3070323845"
"058530","파나케이아","1620","1620","0","0.00","0","0"
"034230","파라다이스","13700","14900","1200","8.76","11456086","153942459750"
"033540","파라텍","1555","1345","-210","-13.50","25571510","36534844005"
"043200","파루","1030","1175","145","14.08","6310105","6902108758"
"214450","파마리서치","65600","69400","3800","5.79","1744596","118656908900"
"217950","파마리서치바이오","32850","35000","2150","6.54","10899","351449150"
"208340","파멥신","4190","3800","-390","-9.31","4639226","17825397100"
"005690","파미셀","12200","13600","1400","11.48","24820759","326407479350"
"177830","파버나인","3890","4145","255","6.56","1651993","6680261235"
"037070","파세코","16650","14050","-2600","-15.62","3476021","52889699000"
"150900","파수","8960","9740","780","8.71","542633","5041108740"
"037030","파워넷","3765","4505","740","19.65","17979361","78654427170"
"047310","파워로직스","5770","6500","730","12.65","7621301","48916818630"
"266870","파워풀엑스","1295","1300","5","0.39","17730","23911850"
"368770","파이버프로","3790","4335","545","14.38","9786556","40628449075"
"170790","파이오링크","10900","11700","800","7.34","183619","2086021850"
"049120","파인디앤씨","1795","1945","150","8.36","4490614","8819585430"
"038950","파인디지털","5460","6060","600","10.99","5595708","32650842810"
"106240","파인테크닉스","11150","11100","-50","-0.45","12840577","150339403850"
"131760","파인텍","1100","1215","115","10.45","4330838","5067777385"
"065690","파커스","2595","2795","200","7.71","281091","750194000"
"140860","파크시스템스","97500","97700","200","0.21","562571","54257887700"
"091700","파트론","8560","8730","170","1.99","10109937","85226595330"
"202960","판도라티비","1385","1885","500","36.10","65136","107257275"
"032800","판타지오","640","765","125","19.53","10943467","8406437068"
"318010","팜스빌","12500","13600","1100","8.80","438689","5628858050"
"036580","팜스코","4985","5320","335","6.72","2350708","11813648565"
"027710","팜스토리","2825","2435","-390","-13.81","44257306","115846729345"
"004720","팜젠사이언스","7640","7750","110","1.44","4925660","41229389230"
"225590","패션플랫폼","1440","1610","170","11.81","14589226","24396106495"
"054300","팬스타엔터프라이즈","727","744","17","2.34","3238092","2325122416"
"068050","팬엔터테인먼트","3380","3760","380","11.24","4008447","14873886715"
"028670","팬오션","5590","5670","80","1.43","53799948","295632187510"
"222110","팬젠","6610","7550","940","14.22","505811","3859541270"
"010820","퍼스텍","3350","3995","645","19.25","98448189","387332948985"
"016800","퍼시스","32950","31700","-1250","-3.79","87093","2771199450"
"263750","펄어비스","52600","59100","6500","12.36","8537453","471541520600"
"251970","펌텍코리아","14900","16200","1300","8.72","294325","4646126400"
"001020","페이퍼코리아","1840","1780","-60","-3.26","10344735","18027807835"
"327610","펨토바이오메드","13900","13600","-300","-2.16","19946","280726700"
"087010","펩트론","10250","9340","-910","-8.88","1598856","15525636730"
"090080","평화산업","1380","1735","355","25.72","88357974","161506672720"
"010770","평화홀딩스","3300","3760","460","13.94","5060724","20780305990"
"119500","포메탈","4710","5210","500","10.62","7190939","36678400710"
"389140","포바이포","21650","20100","-1550","-7.16","18841298","436647678250"
"022100","포스코 ICT","5260","6120","860","16.35","16064131","91151325645"
"058430","포스코스틸리온","33450","39800","6350","18.98","1579899","59505998050"
"009520","포스코엠텍","5520","7160","1640","29.71","82158257","556829951120"
"047050","포스코인터내셔널","18350","22450","4100","22.34","15579980","308327838450"
"003670","포스코케미칼","109000","161500","52500","48.17","15883332","2136664772500"
"189690","포시에스","7320","7290","-30","-0.41","551119","3917318070"
"318020","포인트모바일","18100","18100","0","0.00","0","0"
"256630","포인트엔지니어링","2700","2560","-140","-5.19","945727","2453306290"
"331380","포커스에이치엔에스","2490","2590","100","4.02","1079664","2775935170"
"234100","폴라리스세원","2085","2385","300","14.39","48339342","115916824395"
"041020","폴라리스오피스","1360","1550","190","13.97","4146378","6382447035"
"114630","폴라리스우노","4045","4450","405","10.01","15417265","73324431490"
"290720","푸드나무","20350","24500","4150","20.39","1280898","30245080800"
"005670","푸드웰","6200","6920","720","11.61","4367188","31150865570"
"094940","푸른기술","8150","8530","380","4.66","1912225","15981740920"
"007330","푸른저축은행","8670","10450","1780","20.53","6035825","64258622490"
"017810","풀무원","12550","14650","2100","16.73","1544237","20803900750"
"093380","풍강","4070","4345","275","6.76","718415","3017995910"
"023900","풍국주정","15100","15500","400","2.65","378357","5747151200"
"103140","풍산","24150","27750","3600","14.91","2568527","66880603100"
"005810","풍산홀딩스","25000","28100","3100","12.40","429612","11346651200"
"371950","풍원정밀","15300","13800","-1500","-9.80","1663210","24919806400"
"370090","퓨런티어","30700","27550","-3150","-10.26","9595306","270648481500"
"220100","퓨쳐켐","16950","16250","-700","-4.13","2153418","35090760350"
"035200","프럼파스트","4235","4715","480","11.33","8694074","40767759220"
"334970","프레스티지바이오로직스","4480","4695","215","4.80","16657564","82215210990"
"950210","프레스티지바이오파마","11750","11950","200","1.70","3524168","43815152750"
"203690","프로스테믹스","2370","2025","-345","-14.56","3757185","7816358510"
"321260","프로이천","2020","2320","300","14.85","13643976","31514541500"
"303360","프로테옴텍","4490","6350","1860","41.43","70212","400159700"
"053610","프로텍","22250","24800","2550","11.46","1111487","26523323300"
"377220","프롬바이오","8640","10000","1360","15.74","24845904","243325980850"
"335810","프리시젼바이오","7190","8070","880","12.24","2900994","24064920310"
"053160","프리엠스","9620","9030","-590","-6.13","1880415","17772991980"
"041590","플래스크","1515","2140","625","41.25","35875358","65014642145"
"367000","플래티어","12550","13300","750","5.98","776473","10087863300"
"075130","플랜티넷","2700","2990","290","10.74","1054758","2995254355"
"222670","플럼라인생명과학","5140","5130","-10","-0.19","6953","36326040"
"009810","플레이그램","1220","1080","-140","-11.48","31427378","43898341700"
"237820","플레이디","5340","5970","630","11.80","1256088","7530113530"
"023770","플레이위드","8620","8540","-80","-0.93","2466724","21165736310"
"300080","플리토","30400","40850","10450","34.38","400333","15045152850"
"150440","피노텍","994","994","0","0.00","0","0"
"032580","피델릭스","1450","1620","170","11.72","11123915","17770055180"
"051380","피씨디렉트","14750","13900","-850","-5.76","4981947","81992300250"
"241820","피씨엘","21800","18750","-3050","-13.99","2530993","58139015000"
"237750","피앤씨테크","7630","6740","-890","-11.66","5454284","39768051000"
"024850","피에스엠씨","1025","1015","-10","-0.98","2005644","2047214836"
"319660","피에스케이","38800","35550","-3250","-8.38","3621379","136467573750"
"031980","피에스케이홀딩스","9140","8890","-250","-2.74","1456410","13456503630"
"002230","피에스텍","4200","4040","-160","-3.81","216539","904530615"
"057880","피에이치씨","1740","1740","0","0.00","0","0"
"043370","피에이치에이","7160","7170","10","0.14","1523069","11742794320"
"242350","피엔아이컴퍼니","5520","6300","780","14.13","70081","406967500"
"239890","피엔에이치테크","17350","16950","-400","-2.31","1126342","19830486300"
"347740","피엔케이피부임상연구센타","3925","6830","2905","74.01","51891140","470522417515"
"137400","피엔티","42200","53800","11600","27.49","5588940","257389899000"
"128660","피제이메탈","3900","4410","510","13.08","7636619","33259467450"
"006140","피제이전자","6250","7960","1710","27.36","5038902","39610166100"
"376180","피코그램","38500","51500","13000","33.77","20134405","914275214350"
"304840","피플바이오","8890","10050","1160","13.05","2956358","32573193990"
"062970","피피아이","2855","2925","70","2.45","419932","1193402980"
"087600","픽셀플러스","7860","8160","300","3.82","134965","1086923720"
"161580","필옵틱스","6950","7890","940","13.53","490981","3564317950"
"347770","핌스","13750","14150","400","2.91","617373","8531185550"
"163730","핑거","11850","12500","650","5.49","827141","10186268950"
"332710","하나금융14호스팩","2295","2295","0","0.00","0","0"
"341160","하나금융15호스팩","2280","2070","-210","-9.21","2071996","4342344550"
"343510","하나금융16호스팩","2200","2160","-40","-1.82","125068","272700990"
"388220","하나금융19호스팩","2140","2150","10","0.47","175775","376021440"
"400560","하나금융20호스팩","2280","2220","-60","-2.63","583022","1303603220"
"406760","하나금융21호스팩","2120","2115","-5","-0.24","157488","334544010"
"418170","하나금융22호스팩","2120","2115","-5","-0.24","234987","499548080"
"086790","하나금융지주","37200","39700","2500","6.72","33135912","1211809470565"
"299030","하나기술","51500","54900","3400","6.60","508290","27693259950"
"067310","하나마이크론","13200","12700","-500","-3.79","14449130","190198476700"
"372290","하나머스트7호스팩","2160","2150","-10","-0.46","235137","506236330"
"166090","하나머티리얼즈","43600","37600","-6000","-13.76","3981374","161131220100"
"293480","하나제약","17750","17900","150","0.85","313993","5571254700"
"039130","하나투어","53000","49750","-3250","-6.13","2856720","141868252350"
"136480","하림","3040","2985","-55","-1.81","21766201","64757162760"
"003380","하림지주","8340","8810","470","5.64","4920988","40270703780"
"365590","하이딥","1650","1745","95","5.76","24337608","41494655920"
"149980","하이로닉","7700","7570","-130","-1.69","3040189","22564838140"
"013030","하이록코리아","17100","22200","5100","29.82","2806058","55621518200"
"352820","하이브","164500","177500","13000","7.90","6446702","1088187406500"
"126700","하이비젼시스템","15250","16550","1300","8.52","2464770","39364525850"
"106080","하이소닉","5650","5650","0","0.00","0","0"
"071090","하이스틸","4260","4355","95","2.23","4393797","18405352845"
"377400","하이제6호스팩","2135","2165","30","1.41","244784","524570320"
"400840","하이제7호스팩","2130","2120","-10","-0.47","241529","513195130"
"221840","하이즈항공","4000","4160","160","4.00","1113972","4575001330"
"106190","하이텍팜","10000","9980","-20","-0.20","139358","1375788400"
"019490","하이트론","2470","2470","0","0.00","0","0"
"000080","하이트진로","30650","31300","650","2.12","4786830","144784055150"
"000087","하이트진로2우B","19150","18950","-200","-1.04","39578","735207700"
"000140","하이트진로홀딩스","11250","11700","450","4.00","528991","6193082000"
"000145","하이트진로홀딩스우","14350","15100","750","5.23","3851","56493350"
"373200","하인크코리아","10150","7400","-2750","-27.09","23867732","192460923810"
"066130","하츠","6270","7800","1530","24.40","6632654","51467985160"
"152550","한국ANKOR유전","1570","1595","25","1.59","244521","384839390"
"004590","한국가구","5830","6620","790","13.55","11375249","70956098080"
"036460","한국가스공사","35150","38000","2850","8.11","6839126","243791378600"
"039340","한국경제TV","5900","6270","370","6.27","555139","3347150600"
"005430","한국공항","38400","39200","800","2.08","108262","4080395400"
"071050","한국금융지주","61600","61600","0","0.00","4435183","269382560900"
"071055","한국금융지주우","57900","56500","-1400","-2.42","137186","7695552500"
"034950","한국기업평가","73400","72600","-800","-1.09","24336","1744486200"
"010040","한국내화","3190","3350","160","5.02","625160","2015820290"
"025540","한국단자","51900","58300","6400","12.33","282370","15801908900"
"222980","한국맥널티","6220","6370","150","2.41","5205972","34278383230"
"331660","한국미라클피플사","15150","13000","-2150","-14.19","1525","20711400"
"256840","한국비엔씨","8370","11450","3080","36.80","149423441","1813427978300"
"004090","한국석유","11600","11600","0","0.00","2956606","33297990900"
"025550","한국선재","4305","4985","680","15.80","8904660","41988002875"
"002200","한국수출포장","22950","23550","600","2.61","106834","2397400350"
"002960","한국쉘석유","245500","248500","3000","1.22","18608","4551270500"
"017890","한국알콜","9730","11250","1520","15.62","3107335","32592867850"
"000240","한국앤컴퍼니","12000","13100","1100","9.17","2060093","25255769200"
"080720","한국유니온제약","7220","8230","1010","13.99","629201","4962085110"
"123890","한국자산신탁","3450","3510","60","1.74","2019428","6918139525"
"015760","한국전력","22200","21750","-450","-2.03","21591657","471643122000"
"063570","한국전자금융","5010","5200","190","3.79","1173290","5928601060"
"041460","한국전자인증","5650","6210","560","9.91","5707217","34859077650"
"006200","한국전자홀딩스","1385","1470","85","6.14","3552814","5034088850"
"101680","한국정밀기계","1440","1440","0","0.00","0","0"
"039740","한국정보공학","3795","4310","515","13.57","11952890","50749899005"
"053300","한국정보인증","5790","6050","260","4.49","3375321","20602799980"
"025770","한국정보통신","7540","9700","2160","28.65","16113544","165739473480"
"409570","한국제10호스팩","2165","2145","-20","-0.92","103177","222225525"
"009540","한국조선해양","83300","92900","9600","11.52","4014250","340568240300"
"023350","한국종합기술","7440","7870","430","5.78","12219455","90498755300"
"025890","한국주강","2740","2740","0","0.00","472791","1265430880"
"000970","한국주철관","8120","8350","230","2.83","2397171","20248214610"
"104700","한국철강","6710","7080","370","5.51","1153293","7873023000"
"017960","한국카본","13000","15150","2150","16.54","17911106","249484891350"
"023760","한국캐피탈","779","808","29","3.72","1988839","1580222118"
"054040","한국컴퓨터","3725","3950","225","6.04","1175214","4566789315"
"050540","한국코퍼레이션","822","822","0","0.00","0","0"
"161890","한국콜마","38600","37550","-1050","-2.72","2019552","77147491650"
"024720","한국콜마홀딩스","17300","17000","-300","-1.73","402139","7017005450"
"021650","한국큐빅","3010","3180","170","5.65","2132509","6893863005"
"161390","한국타이어앤테크놀로지","32750","39600","6850","20.92","7500621","262343814150"
"053590","한국테크놀로지","703","761","58","8.25","16722743","13074855496"
"034830","한국토지신탁","1670","1685","15","0.90","18811007","30192987105"
"007280","한국특강","2495","2445","-50","-2.00","1129593","2716136310"
"032300","한국파마","25750","32050","6300","24.47","18082360","660020320000"
"168490","한국패러랠","2135","2180","45","2.11","681721","1488054670"
"037230","한국팩키지","3105","3430","325","10.47","12387174","45324803240"
"010100","한국프랜지","2505","2655","150","5.99","1013218","2551320095"
"047810","한국항공우주","49450","55800","6350","12.84","38278105","2090688401000"
"123690","한국화장품","7210","7300","90","1.25","585500","4184296880"
"003350","한국화장품제조","22400","22100","-300","-1.34","135353","2939293650"
"030520","한글과컴퓨터","17150","16600","-550","-3.21","2650942","45728943750"
"052600","한네트","7080","7820","740","10.45","12912494","100264671200"
"011500","한농화성","12300","14450","2150","17.48","1618177","21367115500"
"002390","한독","17700","18500","800","4.52","306421","5564911350"
"256150","한독크린텍","11000","10850","-150","-1.36","443752","4769216950"
"014790","한라","4015","4760","745","18.56","12298569","54983056445"
"092460","한라IMS","5140","5780","640","12.45","1331103","7181742020"
"060980","한라홀딩스","36250","38350","2100","5.79","332522","12651542400"
"053690","한미글로벌","11550","12250","700","6.06","6273594","73130335050"
"042700","한미반도체","12850","12650","-200","-1.56","10536189","143796806150"
"008930","한미사이언스","41000","41750","750","1.83","1620669","66188384300"
"128940","한미약품","322500","320000","-2500","-0.78","676947","211233091500"
"047080","한빛소프트","3225","3435","210","6.51","1457601","4794046905"
"009240","한샘","60800","54200","-6600","-10.86","1505455","84791219200"
"020000","한섬","30750","29150","-1600","-5.20","1676883","50149050350"
"003680","한성기업","6290","6710","420","6.68","6454204","44141256490"
"105630","한세실업","16900","17050","150","0.89","6863304","115296209550"
"069640","한세엠케이","3370","3535","165","4.90","1038351","4020615035"
"016450","한세예스24홀딩스","5860","5820","-40","-0.68","374496","2194135720"
"010420","한솔PNS","1560","1675","115","7.37","1260592","2013943695"
"009180","한솔로지스틱스","3280","3485","205","6.25","5199301","17311413210"
"070590","한솔인티큐브","1910","1950","40","2.09","987387","1891007270"
"213500","한솔제지","13300","14900","1600","12.03","2727588","38723141650"
"014680","한솔케미칼","214000","213500","-500","-0.23","1020559","222684514000"
"004710","한솔테크닉스","5170","6190","1020","19.73","6082926","36883808835"
"004150","한솔홀딩스","3080","3425","345","11.20","1830899","5983548370"
"025750","한솔홈데코","1330","1445","115","8.65","11581857","16113080265"
"226440","한송네오텍","1530","1530","0","0.00","0","0"
"042520","한스바이오메드","10150","10750","600","5.91","243813","2581289700"
"004960","한신공영","12150","13150","1000","8.23","2407615","29136590450"
"011700","한신기계","9080","9310","230","2.53","40352318","361707592830"
"078350","한양디지텍","12900","14150","1250","9.69","1737047","23421644250"
"045100","한양이엔지","14000","14800","800","5.71","1545952","22476420200"
"001750","한양증권","10450","11300","850","8.13","165515","1777507050"
"001755","한양증권우","15150","16950","1800","11.88","6626","104372550"
"018880","한온시스템","10000","11100","1100","11.00","11481543","119742190420"
"009420","한올바이오파마","17000","17100","100","0.59","3228722","54379717000"
"014130","한익스프레스","5210","5170","-40","-0.77","630752","3253564965"
"046110","한일네트웍스","12000","12450","450","3.75","461286","5619227650"
"024740","한일단조","2745","3355","610","22.22","54500970","180898038695"
"005860","한일사료","6910","5200","-1710","-24.75","42908625","267709016550"
"300720","한일시멘트","13900","15400","1500","10.79","5896099","92798607150"
"123840","한일진공","599","599","0","0.00","1484730","902256831"
"002220","한일철강","3920","4305","385","9.82","1276409","5140200480"
"006390","한일현대시멘트","22450","25400","2950","13.14","334729","8439131350"
"003300","한일홀딩스","10800","11300","500","4.63","59212","640774200"
"007770","한일화학","21700","20050","-1650","-7.60","2953901","61213249200"
"051600","한전KPS","38300","41750","3450","9.01","4459361","172326379400"
"052690","한전기술","68000","72600","4600","6.76","5424257","356059690600"
"130660","한전산업","10800","11000","200","1.85","4211095","44231380820"
"107640","한중엔시에스","11500","12950","1450","12.61","1899","22252350"
"002320","한진","28150","26550","-1600","-5.68","676342","18319292650"
"003480","한진중공업홀딩스","4125","4100","-25","-0.61","1378202","5538576850"
"180640","한진칼","59400","60600","1200","2.02","1237836","73535302700"
"18064K","한진칼우","33700","33300","-400","-1.19","30108","984828000"
"005110","한창","970","1150","180","18.56","211399169","236281977648"
"043090","한창바이오텍","1925","4565","2640","137.14","55077416","225045316400"
"079170","한창산업","7640","8490","850","11.13","12698244","117106269430"
"009460","한창제지","1635","1720","85","5.20","5508354","9451923925"
"086960","한컴MDS","12200","17300","5100","41.80","11800913","193674374250"
"372910","한컴라이프케어","5190","5480","290","5.59","3713364","20926743440"
"054920","한컴위드","4990","5300","310","6.21","8180455","45511006125"
"002680","한탑","2470","1885","-585","-23.68","27997027","58806140175"
"000880","한화","24750","30850","6100","24.65","8289336","228103703800"
"00088K","한화3우B","14100","15700","1600","11.35","1098729","16344954600"
"088350","한화생명","2170","2320","150","6.91","32218089","70934298255"
"000370","한화손해보험","4120","4955","835","20.27","15203613","73133419195"
"009830","한화솔루션","34600","47000","12400","35.84","55826128","2292359998250"
"009835","한화솔루션우","35550","50200","14650","41.21","2880075","139214537750"
"272210","한화시스템","12800","15450","2650","20.70","18347002","259319523050"
"012450","한화에어로스페이스","44600","70600","26000","58.30","39573536","2434659476050"
"000885","한화우","33300","37500","4200","12.61","33799","1217894300"
"003530","한화투자증권","3275","3375","100","3.05","21907495","71928189025"
"003535","한화투자증권우","7690","7450","-240","-3.12","227321","1675456520"
"386580","한화플러스제2호스팩","2205","2200","-5","-0.23","402592","883540280"
"195870","해성디에스","56900","56100","-800","-1.41","6307994","370360132300"
"034810","해성산업","10500","11900","1400","13.33","826092","8932438140"
"03481K","해성산업1우","14600","16200","1600","10.96","217633","3331657400"
"076610","해성옵틱스","827","761","-66","-7.98","10665313","8395401197"
"059270","해성티피씨","6280","7840","1560","24.84","11963610","95040666280"
"101530","해태제과식품","7060","7230","170","2.41","3474608","28462008890"
"220180","핸디소프트","4255","4155","-100","-2.35","13393680","67910745660"
"143210","핸즈코퍼레이션","4010","4145","135","3.37","351377","1454844500"
"900270","헝셩그룹","368","341","-27","-7.34","10008330","3518669830"
"214180","헥토이노베이션","14650","15250","600","4.10","484228","7334266300"
"234340","헥토파이낸셜","18950","22250","3300","17.41","984639","21102190350"
"084990","헬릭스미스","19650","18400","-1250","-6.36","3140877","57982179200"
"000720","현대건설","39550","46450","6900","17.45","12638823","530712053150"
"267270","현대건설기계","42600","40150","-2450","-5.75","4152772","161914858100"
"000725","현대건설우","70700","73300","2600","3.68","78167","5419004900"
"170030","현대공업","6940","7940","1000","14.41","24485387","189816718290"
"005440","현대그린푸드","7720","7870","150","1.94","2667124","20461323460"
"086280","현대글로비스","180000","181500","1500","0.83","2215811","401572267500"
"042670","현대두산인프라코어","5320","5800","480","9.02","23839244","131231433380"
"064350","현대로템","19300","25400","6100","31.61","153093605","3762590201550"
"079430","현대리바트","11100","11700","600","5.41","625502","7075444600"
"012330","현대모비스","204500","224000","19500","9.54","4881057","1076696455908"
"319400","현대무벡스","3050","3180","130","4.26","22985776","73244887135"
"010620","현대미포조선","80500","107000","26500","32.92","6704067","626629118906"
"048410","현대바이오","24700","28800","4100","16.60","15213020","427863226600"
"052260","현대바이오랜드","11800","14800","3000","25.42","8061838","127904111600"
"069960","현대백화점","67100","67500","400","0.60","1332018","87459368800"
"004560","현대비앤지스틸","12650","13950","1300","10.28","1535666","20518723400"
"004565","현대비앤지스틸우","63300","60900","-2400","-3.79","5844","356518200"
"004310","현대약품","5840","5510","-330","-5.65","58793335","362138762720"
"322000","현대에너지솔루션","32200","56300","24100","74.84","17189476","820789636850"
"041440","현대에버다임","9650","8130","-1520","-15.75","29288260","259287228960"
"039010","현대에이치티","8140","8610","470","5.77","143448","1222398170"
"017800","현대엘리베이","26350","29900","3550","13.47","2565346","70604667500"
"307950","현대오토에버","113500","126000","12500","11.01","1259501","156895842000"
"011210","현대위아","55600","70000","14400","25.90","5908289","375566197400"
"090850","현대이지웰","7580","7770","190","2.51","4389003","35134289840"
"267260","현대일렉트릭","23900","30300","6400","26.78","11425383","294494033750"
"004020","현대제철","32750","34400","1650","5.04","9097225","299412565800"
"329180","현대중공업","125500","138500","13000","10.36","5048120","641527102500"
"005380","현대차","178000","193000","15000","8.43","19865054","3791113344904"
"005387","현대차2우B","86400","92400","6000","6.94","1585361","146329917098"
"005389","현대차3우B","83600","88700","5100","6.10","128375","11376072000"
"005385","현대차우","87000","92000","5000","5.75","915110","84334227700"
"001500","현대차증권","9670","10400","730","7.55","743511","7601055740"
"011760","현대코퍼레이션","15500","17300","1800","11.61","1209780","19851058800"
"227840","현대코퍼레이션홀딩스","10500","11550","1050","10.00","463544","5048793500"
"126560","현대퓨처넷","2505","2840","335","13.37","28321981","84952968355"
"001450","현대해상","30650","33600","2950","9.62","7499107","245662223500"
"057050","현대홈쇼핑","50700","51300","600","1.18","208716","10662138250"
"092300","현우산업","4340","4725","385","8.87","16703483","77604609310"
"138360","협진","4480","4480","0","0.00","0","0"
"011080","형지I&C","872","699","-173","-19.84","3247392","2698106519"
"093240","형지엘리트","1595","1715","120","7.52","8020855","13780052490"
"003010","혜인","8530","7780","-750","-8.79","14917701","116331866800"
"111110","호전실업","8290","9030","740","8.93","749603","6542107650"
"008770","호텔신라","69700","73000","3300","4.73","4100278","288512226100"
"008775","호텔신라우","56800","59900","3100","5.46","35468","2078658500"
"060560","홈센타홀딩스","1270","1480","210","16.54","93698792","130966655625"
"064240","홈캐스트","3575","4680","1105","30.91","4970518","19821918465"
"039610","화성밸브","5340","6780","1440","26.97","17560545","119315108350"
"002460","화성산업","18850","17550","-1300","-6.90","1200305","21049086150"
"378850","화승알앤에이","3470","3480","10","0.29","834665","2849378265"
"241590","화승엔터프라이즈","11750","12200","450","3.83","3752902","44586956200"
"006060","화승인더","4665","5060","395","8.47","2650282","12990166510"
"013520","화승코퍼레이션","1525","1480","-45","-2.95","2843701","4064761370"
"010690","화신","8780","9980","1200","13.67","20105025","198634662050"
"126640","화신정공","1610","1765","155","9.63","7994728","13606778145"
"133820","화인베스틸","2605","2990","385","14.78","3402615","8879860910"
"061250","화일약품","2620","2695","75","2.86","47109203","138084404725"
"010660","화천기계","2570","3230","660","25.68","23918012","77888637580"
"000850","화천기공","31950","34250","2300","7.20","122452","4233255800"
"016580","환인제약","16750","17150","400","2.39","402807","6811185600"
"032560","황금에스티","7320","7780","460","6.28","2467334","18426811850"
"004800","효성","76500","75400","-1100","-1.44","895838","66707174800"
"094280","효성ITX","14300","15050","750","5.24","160893","2378102750"
"097870","효성오앤비","9760","9770","10","0.10","4283929","40909036920"
"298040","효성중공업","57100","65700","8600","15.06","1050920","61610989600"
"298050","효성첨단소재","363500","416500","53000","14.58","889016","324650816248"
"298020","효성티앤씨","330000","341000","11000","3.33","763102","243792849000"
"298000","효성화학","176500","191500","15000","8.50","214622","38583933000"
"093370","후성","17700","15800","-1900","-10.73","58685054","994457600850"
"081660","휠라홀딩스","28500","29950","1450","5.09","4507226","133467895900"
"290270","휴네시온","4185","4440","255","6.09","250728","1092089280"
"005870","휴니드","7100","8110","1010","14.23","3839689","29352969880"
"353190","휴럼","1170","1325","155","13.25","10381367","13488187075"
"090710","휴림로봇","3000","3160","160","5.33","405293032","1247135990005"
"205470","휴마시스","18300","18950","650","3.55","124254429","2621765825000"
"115160","휴맥스","3330","3765","435","13.06","13320344","50339417965"
"028080","휴맥스홀딩스","3380","3510","130","3.85","2140202","7877380810"
"032860","휴먼엔","3640","3640","0","0.00","0","0"
"200670","휴메딕스","21600","24500","2900","13.43","1039619","24742548850"
"212310","휴벡셀","6000","5950","-50","-0.83","37076","211954820"
"079980","휴비스","6270","6370","100","1.59","487003","3102516120"
"065510","휴비츠","10950","10650","-300","-2.74","6578183","73116041900"
"215090","휴센텍","1505","1505","0","0.00","0","0"
"005010","휴스틸","4390","4325","-65","-1.48","6613267","27089552845"
"263920","휴엠앤씨","4555","4555","0","0.00","0","0"
"243070","휴온스","35950","38050","2100","5.84","356201","13185061400"
"084110","휴온스글로벌","21800","22850","1050","4.82","1000698","23469128850"
"145020","휴젤","109800","130200","20400","18.58","2412935","303356964400"
"024060","흥구석유","6170","6260","90","1.46","1699778","10443976500"
"010240","흥국","6900","7180","280","4.06","988022","6740185290"
"189980","흥국에프엔비","2910","3200","290","9.97","12011522","38679893995"
"000540","흥국화재","3190","3390","200","6.27","2943434","9465416160"
"000547","흥국화재2우B","22700","22150","-550","-2.42","13346","288922800"
"000545","흥국화재우","7070","7170","100","1.41","17935","126062930"
"003280","흥아해운","2095","1830","-265","-12.65","12584455","23230583330"
"037440","희림","8100","10300","2200","27.16","73323741","661352093210"
"238490","힘스","6240","7670","1430","22.92","3846657","29774968640"