종목코드,종목명,시작일 기준가,종료일 종가,대비,등락률,거래량,거래대금
"060310","3S","2885","2900","15","0.52","13176828","39297369035"
"095570","AJ네트웍스","6520","7860","1340","20.55","2253645","17059507790"
"006840","AK홀딩스","16250","16350","100","0.62","263837","4263082800"
"054620","APS홀딩스","8190","10600","2410","29.43","1935756","18931270460"
"265520","AP시스템","16900","18600","1700","10.06","1532256","26803488750"
"211270","AP위성","11500","11800","300","2.61","6621392","79371739150"
"027410","BGF","4170","4315","145","3.48","2868571","12021720760"
"282330","BGF리테일","189500","173000","-16500","-8.71","807124","146242655500"
"032790","BNGT","4075","4075","0","0.00","0","0"
"138930","BNK금융지주","6630","6820","190","2.87","21544878","142630476616"
"001460","BYC","404500","416000","11500","2.84","2064","853853000"
"001465","BYC우","157000","156000","-1000","-0.64","1365","212689500"
"013720","CBI","1365","1955","590","43.22","50321509","102679501810"
"001040","CJ","77700","80200","2500","3.22","600745","47203778200"
"079160","CJ CGV","21950","21400","-550","-2.51","4698777","98890088800"
"035760","CJ ENM","95800","100800","5000","5.22","1872629","187057384800"
"311690","CJ 바이오사이언스","31450","34500","3050","9.70","434449","14607829350"
"00104K","CJ4우(전환)","70400","71500","1100","1.56","157761","11071737000"
"000120","CJ대한통운","122000","126000","4000","3.28","1113019","129918424500"
"011150","CJ씨푸드","3190","3410","220","6.90","7053556","24038264425"
"011155","CJ씨푸드1우","29750","28550","-1200","-4.03","5054","142095550"
"001045","CJ우","48050","49600","1550","3.23","40952","1971431600"
"097950","CJ제일제당","389000","419500","30500","7.84","969590","392194336500"
"097955","CJ제일제당 우","165500","177000","11500","6.95","30736","5266661000"
"051500","CJ프레시웨이","39150","40600","1450","3.70","1787098","68383734250"
"058820","CMG제약","2620","2855","235","8.97","12377185","33902476680"
"023460","CNH","1795","1935","140","7.80","339775","635750640"
"056730","CNT85","3100","3100","0","0.00","0","0"
"065770","CS","2095","2220","125","5.97","4619678","10324091735"
"083660","CSA 코스믹","1525","1450","-75","-4.92","957164","1400996870"
"000590","CS홀딩스","59400","66500","7100","11.95","231075","15057787100"
"012030","DB","797","833","36","4.52","5318296","4319837241"
"404950","DB금융스팩10호","2100","2095","-5","-0.24","229012","483322700"
"367340","DB금융스팩8호","2135","2130","-5","-0.23","249157","528821720"
"367360","DB금융스팩9호","2155","2125","-30","-1.39","197265","417593585"
"016610","DB금융투자","5020","5240","220","4.38","671990","3373513760"
"005830","DB손해보험","58200","62800","4600","7.90","3206580","197254378155"
"000990","DB하이텍","49000","42900","-6100","-12.45","20486036","888819254050"
"000995","DB하이텍1우","93700","71100","-22600","-24.12","8669","703823900"
"139130","DGB금융지주","7790","7580","-210","-2.70","7805785","59334609310"
"001530","DI동일","16100","19950","3850","23.91","2038062","36033237250"
"000210","DL","67300","67900","600","0.89","2706519","179795442800"
"001880","DL건설","20750","22000","1250","6.02","447785","9541835450"
"000215","DL우","39100","39700","600","1.53","41594","1641299450"
"375500","DL이앤씨","40250","43900","3650","9.07","4780284","193594761850"
"37550L","DL이앤씨2우(전환)","34250","34950","700","2.04","47013","1600570450"
"37550K","DL이앤씨우","28550","29850","1300","4.55","68391","1968533800"
"068790","DMS","5050","5590","540","10.69","1201152","6451404075"
"007340","DN오토모티브","53000","56000","3000","5.66","411049","21925136350"
"004840","DRB동일","4520","4620","100","2.21","270375","1230758810"
"241520","DSC인베스트먼트","4180","4630","450","10.77","6330283","28994333995"
"155660","DSR","5400","6150","750","13.89","1674333","9564792010"
"069730","DSR제강","4795","5350","555","11.57","1243972","6222879225"
"017940","E1","44950","45200","250","0.56","188668","8311651000"
"245620","EDGC","3280","2835","-445","-13.57","44137663","150223110265"
"037370","EG","9200","10550","1350","14.67","804275","7946050310"
"278990","EMB","5490","5990","500","9.11","17863","90538320"
"365550","ESR켄달스퀘어리츠","5460","5520","60","1.10","5017244","26372985374"
"050120","ES큐브","3900","3840","-60","-1.54","786666","3069207095"
"084180","EV수성","1525","1370","-155","-10.16","22197673","32979104665"
"383220","F&F","138000","156500","18500","13.41","2721694","407064735500"
"007700","F&F홀딩스","18800","19800","1000","5.32","795522","15541648150"
"214270","FSN","4420","5050","630","14.25","21208257","111237732370"
"130500","GH신소재","4910","4960","50","1.02","30713115","171286245935"
"114090","GKL","13950","15000","1050","7.53","5024121","71202859250"
"900290","GRT","1240","1300","60","4.84","2698045","3443412350"
"078930","GS","39650","42850","3200","8.07","3837686","154572081350"
"083450","GST","21750","21800","50","0.23","1597608","35026224700"
"006360","GS건설","29550","32050","2500","8.46","15667652","462280342100"
"001250","GS글로벌","3240","3910","670","20.68","229856537","842310451605"
"007070","GS리테일","25500","25750","250","0.98","4901287","120531992500"
"078935","GS우","34550","34950","400","1.16","59003","2018331250"
"297890","HB솔루션","13100","13600","500","3.82","1158732","15434044400"
"078150","HB테크놀러지","1865","2030","165","8.85","13782841","27850248025"
"012630","HDC","6540","6950","410","6.27","1232103","8253885580"
"039570","HDC랩스","8460","8810","350","4.14","890109","8271685980"
"089470","HDC현대EP","3865","4250","385","9.96","435611","1763237170"
"294870","HDC현대산업개발","11450","13050","1600","13.97","6959957","82919682500"
"267250","HD현대","52900","58300","5400","10.21","3178592","171821260750"
"097230","HJ중공업","6800","6870","70","1.03","278117","1893452460"
"195940","HK이노엔","40150","43800","3650","9.09","12455920","531189011200"
"028300","HLB","40300","47800","7500","18.61","26063375","1143160449100"
"003580","HLB글로벌","10100","9680","-420","-4.16","13464191","131713235180"
"343090","HLB사이언스","4100","4180","80","1.95","320386","1244809835"
"067630","HLB생명과학","13000","14200","1200","9.23","26074142","348189342350"
"047920","HLB제약","15650","16550","900","5.75","7831856","119597292350"
"115450","HLB테라퓨틱스","13400","12100","-1300","-9.70","5132290","64139067100"
"011200","HMM","25100","25400","300","1.20","39409295","954740376150"
"036640","HRS","6190","6720","530","8.56","2678091","16947980490"
"082740","HSD엔진","7298","8700","1402","19.21","9067170","80509988080"
"335870","IBKS제12호스팩","2460","2880","420","17.07","6087832","15351418780"
"351340","IBKS제13호스팩","2030","2020","-10","-0.49","1339590","2762906440"
"388790","IBKS제16호스팩","2225","2225","0","0.00","0","0"
"405350","IBKS제17호스팩","2280","2270","-10","-0.44","458950","1052079215"
"003560","IHQ","719","726","7","0.97","11357984","8564229891"
"095340","ISC","32550","31350","-1200","-3.69","4489965","148190248200"
"099520","ITX-AI","1285","1285","0","0.00","0","0"
"175330","JB금융지주","7130","7370","240","3.37","5817649","42437960610"
"950170","JTC","2845","2690","-155","-5.45","658792","1773216845"
"234080","JW생명과학","13350","13700","350","2.62","271273","3691201700"
"067290","JW신약","3845","4140","295","7.67","8714492","35793085410"
"001060","JW중외제약","24050","23050","-1000","-4.16","1742640","42494840400"
"001067","JW중외제약2우B","70300","70500","200","0.28","2852","202825700"
"001065","JW중외제약우","36600","36550","-50","-0.14","5644","203467550"
"096760","JW홀딩스","3360","3455","95","2.83","705682","2439393675"
"035900","JYP Ent.","53400","57600","4200","7.87","8269223","463335593000"
"318000","KBG","5930","6600","670","11.30","1030705","6446928750"
"024840","KBI메탈","1715","1835","120","7.00","2624851","4725184695"
"105560","KB금융","47000","51400","4400","9.36","25542373","1213918827851"
"024120","KB오토시스","5620","5480","-140","-2.49","1315900","7126476600"
"002380","KCC","287500","307500","20000","6.96","772410","225411062500"
"021320","KCC건설","6870","7270","400","5.82","421706","2896963020"
"344820","KCC글라스","44800","49400","4600","10.27","494412","22795694900"
"036670","KCI","8190","8870","680","8.30","209918","1806388780"
"009070","KCTC","4460","5180","720","16.14","8288679","43608661230"
"009440","KC그린홀딩스","5020","4945","-75","-1.49","2666986","13055928005"
"112190","KC산업","3420","3695","275","8.04","15758","53561315"
"119650","KC코트렐","4230","4620","390","9.22","1189639","5274206505"
"044180","KD","1035","1075","40","3.86","1591798","1627265425"
"092220","KEC","2545","2725","180","7.07","44107123","119262407545"
"151860","KG ETS","15850","15750","-100","-0.63","27278594","418873524750"
"046440","KG모빌리언스","7130","7320","190","2.66","3762873","26294234000"
"016380","KG스틸","13150","12700","-450","-3.42","14610921","181892564850"
"035600","KG이니시스","13700","14150","450","3.28","2477737","33957780150"
"001390","KG케미칼","26100","29200","3100","11.88","7648375","216705972250"
"226360","KH 건설","919","868","-51","-5.55","171516322","151920039076"
"111870","KH 전자","753","814","61","8.10","34503295","26627109702"
"033180","KH 필룩스","1525","1510","-15","-0.98","17041947","25237090890"
"060720","KH바텍","18200","19500","1300","7.14","4491178","90473420700"
"001940","KISCO홀딩스","14050","14250","200","1.42","409114","5713981600"
"058400","KNN","1010","1070","60","5.94","7206249","7516556509"
"114450","KPX생명과학","5280","5610","330","6.25","26522251","170857773580"
"025000","KPX케미칼","47950","51400","3450","7.19","49756","2462274300"
"092230","KPX홀딩스","59600","60500","900","1.51","15296","913980600"
"000040","KR모터스","633","717","84","13.27","57436045","44577380064"
"044450","KSS해운","9650","10900","1250","12.95","687484","6888867430"
"030200","KT","36650","38500","1850","5.05","16033165","601822481325"
"033780","KT&G","80700","81200","500","0.62","5087501","414050804300"
"058850","KTcs","2015","2395","380","18.86","19626266","45161809180"
"058860","KTis","2595","2815","220","8.48","7388295","19825596950"
"060370","KT서브마린","6450","6980","530","8.22","13905530","94693860650"
"122450","KX","7690","7860","170","2.21","984068","7498771690"
"052900","KX하이텍","1380","1500","120","8.70","10257745","15316946850"
"093050","LF","16150","17000","850","5.26","947842","15709868900"
"003550","LG","78400","81600","3200","4.08","3563524","280676993000"
"034220","LG디스플레이","15250","16450","1200","7.87","28430194","434522392550"
"051900","LG생활건강","714000","742000","28000","3.92","1244952","923868832271"
"051905","LG생활건강우","330500","363500","33000","9.98","109357","38335436000"
"373220","LG에너지솔루션","388000","469500","81500","21.01","12427920","5091443836500"
"003555","LG우","61400","62800","1400","2.28","40658","2505399100"
"032640","LG유플러스","12300","12600","300","2.44","15654861","193126406808"
"011070","LG이노텍","338000","342000","4000","1.18","4873673","1679816234000"
"066570","LG전자","92000","96400","4400","4.78","13234443","1233827829200"
"066575","LG전자우","44800","47050","2250","5.02","396762","18134333300"
"037560","LG헬로비전","5610","5480","-130","-2.32","12394725","70081637320"
"051910","LG화학","540000","670000","130000","24.07","6109306","3547991919491"
"051915","LG화학우","254500","327000","72500","28.49","328233","92187310058"
"079550","LIG넥스원","69400","90200","20800","29.97","5622089","465782549300"
"006260","LS","55400","62100","6700","12.09","3061131","170152798600"
"010120","LS ELECTRIC","53200","58800","5600","10.53","3550303","194687114100"
"000680","LS네트웍스","2650","3135","485","18.30","1865975","5572662700"
"229640","LS전선아시아","6920","7370","450","6.50","5771951","42463038230"
"108320","LX세미콘","95500","93000","-2500","-2.62","4566291","428175027200"
"001120","LX인터내셔널","29600","33600","4000","13.51","5915872","184321324000"
"108670","LX하우시스","42100","45200","3100","7.36","530444","22750171900"
"108675","LX하우시스우","20400","21900","1500","7.35","64932","1308135200"
"383800","LX홀딩스","8950","8660","-290","-3.24","2942588","25505902600"
"38380K","LX홀딩스1우","12150","12250","100","0.82","67919","813983100"
"023150","MH에탄올","8550","9090","540","6.32","3313123","31559357070"
"035420","NAVER","249000","269000","20000","8.03","14909058","3761672520094"
"160550","NEW","7150","8490","1340","18.74","7339919","57660942420"
"053290","NE능률","5410","5650","240","4.44","20898250","135676238160"
"181710","NHN","27650","29400","1750","6.33","2253816","63793019700"
"104200","NHN벅스","9070","9260","190","2.09","6655679","63726642170"
"060250","NHN한국사이버결제","12850","13650","800","6.23","14079269","195345212500"
"400760","NH올원리츠","4540","4635","95","2.09","1099527","4900734880"
"005940","NH투자증권","9230","10050","820","8.88","12917511","122527677020"
"005945","NH투자증권우","9210","9920","710","7.71","732613","6958194210"
"338100","NH프라임리츠","4660","4670","10","0.21","621458","2856455755"
"034310","NICE","14600","13400","-1200","-8.22","1154378","16115550850"
"030190","NICE평가정보","14250","16400","2150","15.09","2049264","31009996783"
"008260","NI스틸","4850","5030","180","3.71","2525321","12511613190"
"004250","NPC","8770","9730","960","10.95","38239694","364693605620"
"004255","NPC우","4725","5060","335","7.09","6616672","34756185520"
"010060","OCI","127000","126500","-500","-0.39","14199771","1667137346500"
"178920","PI첨단소재","33850","38750","4900","14.48","2484883","88611387350"
"024940","PN풍년","4910","5710","800","16.29","4704099","24244294905"
"005490","POSCO홀딩스","231000","254500","23500","10.17","5985422","1402705946130"
"218410","RFHIC","21900","23650","1750","7.99","2139317","48237721400"
"327260","RF머트리얼즈","11150","10700","-450","-4.04","348562","3839571700"
"091340","S&K폴리텍","4235","4500","265","6.26","192489","836259660"
"010950","S-Oil","93000","86500","-6500","-6.99","9540960","854810148672"
"010955","S-Oil우","58000","56800","-1200","-2.07","301230","17276225300"
"019550","SBI인베스트먼트","1550","1465","-85","-5.48","20741653","30131384300"
"950110","SBI핀테크솔루션즈","4305","4805","500","11.61","125841","579112665"
"034120","SBS","42600","43600","1000","2.35","937791","39034981000"
"046140","SBS콘텐츠허브","6030","6990","960","15.92","2105082","14836265230"
"151910","SBW생명과학","3800","3260","-540","-14.21","5387324","19276780580"
"036120","SCI평가정보","3340","2970","-370","-11.08","18460230","62573170645"
"099220","SDN","2510","3030","520","20.72","276087164","809866302020"
"036540","SFA반도체","5140","5350","210","4.09","34574907","185173397535"
"255220","SG","1595","1775","180","11.29","25943260","47925080880"
"040610","SG&G","1995","2140","145","7.27","9352454","19984901795"
"049470","SGA","943","940","-3","-0.32","4114253","3861789110"
"184230","SGA솔루션즈","865","981","116","13.41","36936951","37720843282"
"005090","SGC에너지","33600","38350","4750","14.14","1513402","54120776850"
"016250","SGC이테크건설","43500","50100","6600","15.17","114017","5299520650"
"001380","SG글로벌","1360","1485","125","9.19","2802400","4143749495"
"004060","SG세계물산","560","618","58","10.36","16701770","9835360339"
"001770","SHD","30050","32150","2100","6.99","200684","6095074100"
"002360","SH에너지화학","1000","1105","105","10.50","104067607","111316347602"
"009160","SIMPAC","6250","6570","320","5.12","2779531","17438809030"
"123700","SJM","3500","3665","165","4.71","187781","676922660"
"025530","SJM홀딩스","3005","3130","125","4.16","1323047","4005008595"
"034730","SK","208500","228500","20000","9.59","2523440","543889206488"
"337450","SK5호스팩","5040","3405","-1635","-32.44","64368879","322733658080"
"340350","SK6호스팩","2265","2115","-150","-6.62","7888943","17130508965"
"011790","SKC","132000","133000","1000","0.76","4330666","570476371000"
"018670","SK가스","112000","116500","4500","4.02","261132","29160430000"
"001740","SK네트웍스","4250","4370","120","2.82","8246078","35951161550"
"001745","SK네트웍스우","57600","61800","4200","7.29","5168","304124400"
"006120","SK디스커버리","34800","36350","1550","4.45","337015","11978461550"
"006125","SK디스커버리우","30250","30800","550","1.82","35948","1095984850"
"210980","SK디앤디","24800","28250","3450","13.91","461180","11752718750"
"068400","SK렌터카","8260","8840","580","7.02","3410660","31772962530"
"395400","SK리츠","5710","5450","-260","-4.55","6704412","35976612480"
"302440","SK바이오사이언스","140000","124000","-16000","-11.43","20584198","2812585726500"
"326030","SK바이오팜","78800","80600","1800","2.28","2091198","164518110100"
"402340","SK스퀘어","39800","43550","3750","9.42","6695526","278176156220"
"260870","SK시그넷","48350","51100","2750","5.69","156475","8097704800"
"361610","SK아이이테크놀로지","82000","93700","11700","14.27","11035948","929098209600"
"03473K","SK우","184500","196000","11500","6.23","13629","2532210000"
"096770","SK이노베이션","171500","194500","23000","13.41","8267989","1491954957000"
"096775","SK이노베이션우","110500","120000","9500","8.60","44815","5114379500"
"001510","SK증권","726","773","47","6.47","21301288","15883040698"
"001515","SK증권우","2980","3095","115","3.86","113318","341043145"
"285130","SK케미칼","102000","106500","4500","4.41","1318368","138066981500"
"28513K","SK케미칼우","51700","53100","1400","2.71","141066","7452436400"
"017670","SK텔레콤","54000","52700","-1300","-2.41","11015353","590436424301"
"000660","SK하이닉스","94800","94200","-600","-0.63","66329152","6484676379462"
"048550","SM C&C","3350","4090","740","22.09","50754153","197667780470"
"063440","SM Life Design","2130","2400","270","12.68","20464641","48249867300"
"064960","SNT모티브","41000","42000","1000","2.44","806225","34615259500"
"100840","SNT에너지","16550","17800","1250","7.55","608338","9889338250"
"003570","SNT중공업","6800","9140","2340","34.41","11010414","92280336050"
"036530","SNT홀딩스","15450","15550","100","0.65","494999","7926524600"
"005610","SPC삼립","80900","86200","5300","6.55","308004","25168876700"
"011810","STX","3275","3520","245","7.48","764300","2523350965"
"077970","STX엔진","13200","15750","2550","19.32","2816847","40834376700"
"071970","STX중공업","4260","4690","430","10.09","1447275","6261870700"
"002820","SUN&L","4590","4555","-35","-0.76","281807","1256599280"
"289080","SV인베스트먼트","2655","2915","260","9.79","21152222","62257555750"
"084870","TBH글로벌","1980","2050","70","3.54","1930005","3926310050"
"002710","TCC스틸","12600","14250","1650","13.10","16822171","228502877450"
"089230","THE E&M","456","543","87","19.08","32059709","17261671767"
"161570","THE MIDONG","1235","1255","20","1.62","759878","936610630"
"192410","THQ","4765","4550","-215","-4.51","8046514","38637533275"
"032540","TJ미디어","5830","6650","820","14.07","3430304","22069038960"
"022220","TKG애강","1880","1875","-5","-0.27","26628682","51799759100"
"069260","TKG휴켐스","19900","20150","250","1.26","3186660","62399894100"
"048770","TPC","4795","4875","80","1.67","15424689","75926888530"
"246690","TS인베스트먼트","2580","2345","-235","-9.11","34367757","83240398055"
"317240","TS트릴리온","853","872","19","2.23","7625097","6457015898"
"002900","TYM","2510","2435","-75","-2.99","166452135","428497292025"
"038340","UCI","1335","1335","0","0.00","0","0"
"073570","WI","1020","919","-101","-9.90","13732503","13578199209"
"024070","WISCOM","3300","3200","-100","-3.03","373518","1192171240"
"057030","YBM넷","4060","4695","635","15.64","16881438","87176487145"
"037270","YG PLUS","5470","6840","1370","25.05","17979167","112243621610"
"040300","YTN","3650","3620","-30","-0.82","276455","993626070"
"051390","YW","3680","3850","170","4.62","217782","814304475"
"052220","iMBC","3180","3460","280","8.81","1174543","3810626190"
"079940","가비아","11100","12250","1150","10.36","438145","5094589550"
"078890","가온미디어","8470","8380","-90","-1.06","3984684","33828146790"
"000500","가온전선","23150","21000","-2150","-9.29","385497","8450743850"
"399720","가온칩스","24650","27200","2550","10.34","13101939","337276786600"
"036620","감성코퍼레이션","1625","1770","145","8.92","9772517","16978230000"
"000860","강남제비스코","21050","23450","2400","11.40","152871","3426445550"
"217730","강스템바이오텍","2845","3930","1085","38.14","5093221","18002801715"
"035250","강원랜드","25450","25650","200","0.79","10568038","261855144950"
"114190","강원에너지","6370","5130","-1240","-19.47","6890449","38226844650"
"094480","갤럭시아머니트리","6080","7540","1460","24.01","39272444","301863927380"
"011420","갤럭시아에스엠","1865","2040","175","9.38","7105560","13858366445"
"039240","경남스틸","3275","3640","365","11.15","2914755","9825210860"
"053950","경남제약","2655","2545","-110","-4.14","19816577","57488562040"
"002100","경농","10850","11700","850","7.83","944777","10529827500"
"009450","경동나비엔","38450","38950","500","1.30","767959","30213189700"
"267290","경동도시가스","20550","23700","3150","15.33","1339918","30466304950"
"012320","경동인베스트","34000","34450","450","1.32","63599","2227329150"
"011040","경동제약","8930","8850","-80","-0.90","1657745","15041088380"
"000050","경방","12300","13100","800","6.50","107963","1389818450"
"214390","경보제약","7140","7130","-10","-0.14","278342","2000941580"
"012610","경인양행","5460","6040","580","10.62","2971355","17176266560"
"009140","경인전자","25500","27850","2350","9.22","74441","1962512300"
"024910","경창산업","2430","2610","180","7.41","1051702","2656074945"
"013580","계룡건설","25000","26050","1050","4.20","951978","23043336000"
"012200","계양전기","3060","3310","250","8.17","4628970","15190754145"
"012205","계양전기우","6670","5870","-800","-11.99","429388","2710152430"
"002140","고려산업","7070","4885","-2185","-30.91","29963169","180847690510"
"198440","고려시멘트","3450","3720","270","7.83","30127358","112841248270"
"049720","고려신용정보","11600","10600","-1000","-8.62","18611973","222121887350"
"010130","고려아연","463000","585000","122000","26.35","1108818","554318176000"
"002240","고려제강","20400","21550","1150","5.64","627359","12873098850"
"014570","고려제약","7700","8150","450","5.84","633586","5087476730"
"348150","고바이오랩","12750","14000","1250","9.80","744156","10184513800"
"098460","고영","13450","14600","1150","8.55","4810885","66738833905"
"035290","골드앤에스","2410","2425","15","0.62","9284807","24472892970"
"038530","골드퍼시픽","674","666","-8","-1.19","49896119","38839829323"
"900280","골든센츄리","371","382","11","2.96","35610614","14221006149"
"215000","골프존","139900","138600","-1300","-0.93","971042","135758291400"
"121440","골프존뉴딘홀딩스","7050","6930","-120","-1.70","885186","6039898070"
"183410","골프존데카","4390","4480","90","2.05","14412","61098520"
"366030","공구우먼","31600","11350","-20250","-64.08","34579951","514048842200"
"076340","관악산업","6700","6990","290","4.33","31564","165029030"
"009290","광동제약","6390","6710","320","5.01","8294321","57395216340"
"014200","광림","1490","1435","-55","-3.69","28621381","41113014235"
"017040","광명전기","3170","2930","-240","-7.57","19552832","58751805485"
"029480","광무","2855","3695","840","29.42","3798064","13969197430"
"017900","광전자","2260","2450","190","8.41","1609140","3771919525"
"037710","광주신세계","33300","33500","200","0.60","107958","3557051950"
"026910","광진실업","4895","5820","925","18.90","1254617","7077587745"
"355150","교보10호스팩","2240","2240","0","0.00","245621","549751790"
"397880","교보11호스팩","2145","2130","-15","-0.70","324126","696562715"
"421800","교보12호스팩","2105","2115","10","0.48","454236","961925490"
"331520","교보9호스팩","2470","2260","-210","-8.50","23914025","60260627345"
"030610","교보증권","6350","6440","90","1.42","727890","4553291580"
"339770","교촌에프앤비","11800","12150","350","2.97","750777","8918264700"
"053270","구영테크","3275","3360","85","2.60","17952875","61402451885"
"007690","국도화학","48850","51600","2750","5.63","549037","27085107150"
"005320","국동","1785","1805","20","1.12","27885782","55442763765"
"001140","국보","1190","1075","-115","-9.66","21099318","23739935480"
"066620","국보디자인","17000","17750","750","4.41","400158","6956420750"
"043650","국순당","8830","9390","560","6.34","1320767","11982597340"
"006050","국영지앤엠","1530","1630","100","6.54","10973077","18343681745"
"060480","국일신동","2970","3685","715","24.07","16498551","65092967635"
"078130","국일제지","2615","2715","100","3.82","9154613","23888138505"
"307750","국전약품","7380","8080","700","9.49","71980482","659752045780"
"002720","국제약품","5770","5590","-180","-3.12","11426673","67000897840"
"243870","굿센","15000","15500","500","3.33","2899","45532350"
"035080","그래디언트","18000","19550","1550","8.61","1636459","30024557150"
"204020","그리티","3145","3330","185","5.88","5766632","19031618190"
"083420","그린케미칼","7080","8950","1870","26.41","24555071","220254421480"
"186230","그린플러스","12000","13450","1450","12.08","881858","11187020550"
"014530","극동유화","3615","3775","160","4.43","2450273","8929607335"
"900070","글로벌에스엠","800","779","-21","-2.63","8044878","6392803767"
"204620","글로벌텍스프리","2475","2450","-25","-1.01","4774096","12488193970"
"019660","글로본","2490","2910","420","16.87","6086383","16544255575"
"014280","금강공업","7140","7450","310","4.34","2077735","14634465600"
"014285","금강공업우","12900","13050","150","1.16","26208","334139250"
"053260","금강철강","7120","7060","-60","-0.84","1955344","13506467340"
"008870","금비","71100","71000","-100","-0.14","49926","3735931400"
"001570","금양","5200","10300","5100","98.08","281284358","2428881299840"
"002990","금호건설","8010","8790","780","9.74","1225682","10064946460"
"002995","금호건설우","26550","28800","2250","8.47","6268","168280900"
"011780","금호석유","138000","133500","-4500","-3.26","2369868","298581857000"
"011785","금호석유우","87600","90300","2700","3.08","201219","17022907100"
"214330","금호에이치티","1290","1215","-75","-5.81","26641943","34386381890"
"001210","금호전기","1400","1415","15","1.07","4295686","5891936225"
"073240","금호타이어","3475","3730","255","7.34","5427339","19175141700"
"036190","금화피에스시","29850","30200","350","1.17","54322","1600048750"
"049080","기가레인","1525","1605","80","5.25","10956764","17296132405"
"035460","기산텔레콤","3425","4060","635","18.54","31623560","117882011160"
"092440","기신정기","3485","3750","265","7.60","371111","1336425330"
"000270","기아","76800","80800","4000","5.21","28770720","2323576938856"
"024110","기업은행","9210","9580","370","4.02","20142545","186665156870"
"013700","까뮤이앤씨","1910","2385","475","24.87","74231320","170737240565"
"308100","까스텔바작","9980","11100","1120","11.22","18344178","192635812080"
"004540","깨끗한나라","3505","3680","175","4.99","3470904","12758038780"
"004545","깨끗한나라우","19300","20050","750","3.89","7263","139719400"
"187790","나노","1095","1205","110","10.05","2421659","2817274785"
"286750","나노브릭","2065","2320","255","12.35","5609880","12822299215"
"121600","나노신소재","72100","88700","16600","23.02","4272210","342839850600"
"247660","나노씨엠에스","34500","30950","-3550","-10.29","4702774","165461539400"
"039860","나노엔텍","5440","5590","150","2.76","20761454","129337498440"
"091970","나노캠텍","1610","1610","0","0.00","0","0"
"244880","나눔테크","3035","3075","40","1.32","1345","3987535"
"288490","나라소프트","145","125","-20","-13.79","312396","39492861"
"051490","나라엠앤디","6420","7420","1000","15.58","5640595","40251286300"
"137080","나래나노텍","9110","9070","-40","-0.44","4409997","42235951180"
"190510","나무가","9430","10200","770","8.17","3544660","35823613590"
"242040","나무기술","1790","2055","265","14.80","21812768","47036686985"
"089600","나스미디어","22800","25700","2900","12.72","454835","11140528650"
"293580","나우IB","8550","8580","30","0.35","1359750","12257259010"
"257990","나우코스","5880","7100","1220","20.75","21210","137083670"
"138610","나이벡","24000","24000","0","0.00","1064076","26219259500"
"130580","나이스디앤비","7310","7900","590","8.07","788945","6709730190"
"036800","나이스정보통신","25200","26100","900","3.57","691432","17953358050"
"267320","나인테크","3605","4010","405","11.23","46476753","179560933820"
"001260","남광토건","11350","11550","200","1.76","2038962","22452876290"
"008350","남선알미늄","2130","2260","130","6.10","62410855","141399344990"
"008355","남선알미우","22050","23800","1750","7.94","81168","1903588500"
"004270","남성","2260","2450","190","8.41","2522764","6133291705"
"003920","남양유업","369500","385000","15500","4.19","12558","4659062000"
"003925","남양유업우","199500","213000","13500","6.77","2112","430134000"
"025860","남해화학","9650","10050","400","4.15","9838103","94984968050"
"111710","남화산업","7450","8080","630","8.46","190851","1453864540"
"091590","남화토건","7480","7870","390","5.21","1511915","11946676390"
"168330","내츄럴엔도텍","4265","4895","630","14.77","1047624","5102544210"
"094860","네오리진","717","738","21","2.93","22120376","17343698681"
"253590","네오셈","3430","3315","-115","-3.35","3533062","12081160170"
"212560","네오오토","6050","7470","1420","23.47","6221897","46416365380"
"095660","네오위즈","25900","28100","2200","8.49","7603917","209709048400"
"042420","네오위즈홀딩스","29450","32700","3250","11.04","2313991","74468508200"
"950220","네오이뮨텍","4520","5200","680","15.04","58795656","301785843230"
"311390","네오크레마","13800","13950","150","1.09","1849617","28313066100"
"085910","네오티스","5010","5470","460","9.18","1775115","9230939835"
"092730","네오팜","20150","20400","250","1.24","233018","4769712400"
"290660","네오펙트","2095","2190","95","4.53","1755168","3967071810"
"306620","네온테크","4405","4490","85","1.93","41369213","191524063985"
"153460","네이블","7180","7400","220","3.06","193343","1449537630"
"007390","네이처셀","18950","23200","4250","22.43","23826168","548943135750"
"033640","네패스","19250","20350","1100","5.71","2404254","46873256000"
"330860","네패스아크","28550","29200","650","2.28","846016","24086290400"
"005720","넥센","3470","3640","170","4.90","258280","916669200"
"005725","넥센우","3085","3030","-55","-1.78","88164","257116610"
"002350","넥센타이어","5520","6510","990","17.93","3031849","18835273930"
"002355","넥센타이어1우B","2745","2930","185","6.74","392759","1075580200"
"089140","넥스턴바이오","2785","3345","560","20.11","57055032","194520952970"
"137940","넥스트아이","720","741","21","2.92","5228073","3952393077"
"396270","넥스트칩","14700","11000","-3700","-25.17","16802546","216917625900"
"348210","넥스틴","59000","56000","-3000","-5.08","1413663","85704722800"
"225570","넥슨게임즈","17450","22350","4900","28.08","21012894","435283912350"
"217270","넵튠","11650","15050","3400","29.18","7422311","115069355050"
"251270","넷마블","68700","72300","3600","5.24","4590288","322700916700"
"317860","노드메이슨","7300","8490","1190","16.30","2084","15469890"
"104620","노랑풍선","8230","7750","-480","-5.83","1262818","9540041530"
"090350","노루페인트","8360","9850","1490","17.82","5078350","47538298930"
"090355","노루페인트우","15000","17400","2400","16.00","27114","436854350"
"000320","노루홀딩스","10750","11600","850","7.91","253814","2885692500"
"000325","노루홀딩스우","25500","21500","-4000","-15.69","99935","2213232800"
"194700","노바렉스","29100","32750","3650","12.54","439303","13778664750"
"285490","노바텍","31850","32700","850","2.67","1090261","36712717050"
"229500","노브메타파마","12500","13350","850","6.80","31085","388559850"
"106520","노블엠앤비","3625","3990","365","10.07","6545321","25473220980"
"376930","노을","9230","7410","-1820","-19.72","6223933","49623081930"
"278650","노터스","8250","6780","-1470","-17.82","110953180","827077798650"
"006280","녹십자","177000","172000","-5000","-2.82","697630","123706507500"
"142280","녹십자엠에스","7760","7820","60","0.77","23960568","202187238210"
"234690","녹십자웰빙","8010","8190","180","2.25","1146867","9426603440"
"005250","녹십자홀딩스","19950","20650","700","3.51","2037594","42594731500"
"005257","녹십자홀딩스2우","56500","56400","-100","-0.18","130602","8080284400"
"065560","녹원씨엔아이","5770","5770","0","0.00","0","0"
"004370","농심","283000","297000","14000","4.95","472362","134392689500"
"072710","농심홀딩스","68400","68300","-100","-0.15","46113","3111923000"
"054050","농우바이오","9850","10150","300","3.05","632432","6339859900"
"069140","누리플랜","5840","5700","-140","-2.40","435668","2489749350"
"040160","누리플렉스","6840","6400","-440","-6.43","3333700","22768207280"
"332290","누보","2795","2310","-485","-17.35","13009304","31916398390"
"126870","뉴로스","2230","2230","0","0.00","0","0"
"060260","뉴보텍","1120","1325","205","18.30","52439918","65775750325"
"012340","뉴인텍","2970","4015","1045","35.19","81564989","322668759310"
"214870","뉴지랩파마","9080","13950","4870","53.63","9693515","112037227030"
"270870","뉴트리","13100","13500","400","3.05","964689","12444816000"
"144960","뉴파워프라즈마","4060","4570","510","12.56","1796242","8151471310"
"085670","뉴프렉스","4305","5180","875","20.33","10824813","53196159860"
"119860","다나와","17350","18900","1550","8.93","493409","8935159350"
"064260","다날","7170","7710","540","7.53","40912184","309417594330"
"093640","다믈멀티미디어","3720","4235","515","13.84","957580","3940485630"
"340360","다보링크","1235","1365","130","10.53","3752264","4826695775"
"039560","다산네트웍스","5670","5930","260","4.59","1079732","6259250390"
"058730","다스코","5500","6270","770","14.00","24626209","138552971665"
"298870","다올인베스트먼트","3180","3325","145","4.56","14645147","50957918110"
"030210","다올투자증권","4285","4445","160","3.73","2199684","9551704495"
"023590","다우기술","17800","18900","1100","6.18","712171","13107863550"
"032190","다우데이타","10250","11700","1450","14.15","1373748","14860688910"
"323350","다원넥스뷰","54000","47000","-7000","-12.96","1057","53901900"
"068240","다원시스","22550","23750","1200","5.32","3512661","79157524600"
"145210","다이나믹디자인","4735","4700","-35","-0.74","204508","947863200"
"271850","다이오진","1690","1690","0","0.00","0","0"
"019680","대교","2920","3050","130","4.45","1320332","4039861690"
"019685","대교우B","2175","2270","95","4.37","420171","994054990"
"006370","대구백화점","11250","10650","-600","-5.33","59458","638450400"
"008060","대덕","6220","6680","460","7.40","1251325","8190121400"
"00806K","대덕1우","9200","9200","0","0.00","34624","318723790"
"353200","대덕전자","28150","27400","-750","-2.66","15100444","432725019600"
"35320K","대덕전자1우","12300","12300","0","0.00","114585","1428325050"
"000490","대동","11450","12100","650","5.68","6931640","83669302700"
"178600","대동고려삼","4200","3840","-360","-8.57","25270","89541175"
"020400","대동금속","9060","10200","1140","12.58","2952146","30187236740"
"008830","대동기어","7200","8260","1060","14.72","17438090","151181934270"
"048470","대동스틸","4980","5710","730","14.66","9646016","56286838025"
"008110","대동전자","6450","13700","7250","112.40","51553603","568853533250"
"004780","대륙제관","4615","4815","200","4.33","7703880","38702872415"
"005750","대림B&Co","5000","6150","1150","23.00","5497700","33283498635"
"017650","대림제지","8640","8960","320","3.70","276247","2451139880"
"006570","대림통상","3895","3915","20","0.51","297086","1077620585"
"007720","대명소노시즌","852","900","48","5.63","3738583","3232507774"
"389260","대명에너지","14700","24200","9500","64.63","23439326","456198438950"
"317850","대모","8330","8000","-330","-3.96","6635920","53498333260"
"290670","대보마그네틱","41350","48250","6900","16.69","1165717","53480268750"
"078140","대봉엘에스","7420","8420","1000","13.48","16292909","152103579880"
"001680","대상","21400","23700","2300","10.75","2722379","60998959500"
"001685","대상우","16050","17000","950","5.92","96479","1577446350"
"084690","대상홀딩스","7990","8810","820","10.26","1031815","8571055920"
"084695","대상홀딩스우","10000","10400","400","4.00","306857","3157409290"
"036480","대성미생물","12300","13050","750","6.10","154416","1946658000"
"128820","대성산업","5110","5090","-20","-0.39","10570376","53358517495"
"117580","대성에너지","10750","13900","3150","29.30","30079516","378692883950"
"025440","대성엘텍","884","934","50","5.66","25441613","22784226524"
"027830","대성창투","3000","3455","455","15.17","152591549","652314191565"
"104040","대성파인텍","1625","1960","335","20.62","44264769","89591283765"
"016710","대성홀딩스","75500","86000","10500","13.91","2805388","228829849800"
"387310","대신밸런스제10호스팩","2265","2320","55","2.43","367728","834898060"
"397500","대신밸런스제11호스팩","2680","2680","0","0.00","0","0"
"020180","대신정보통신","1150","1380","230","20.00","42078604","58195475955"
"003540","대신증권","14900","15350","450","3.02","843855","12663335750"
"003547","대신증권2우B","13300","13750","450","3.38","268021","3573603600"
"003545","대신증권우","13550","14250","700","5.17","838218","11546526500"
"045390","대아티아이","3385","3715","330","9.75","23071809","84767825705"
"009190","대양금속","3560","3950","390","10.96","10268998","39545157735"
"108380","대양전기공업","12300","13500","1200","9.76","574069","7079682750"
"006580","대양제지","3260","3260","0","0.00","0","0"
"014160","대영포장","1650","1785","135","8.18","22507591","40608876635"
"047040","대우건설","5640","5500","-140","-2.48","42313250","224501431730"
"009320","대우부품","1810","2155","345","19.06","8263561","18043705280"
"042660","대우조선해양","20400","21600","1200","5.88","10774769","216668542900"
"003090","대웅","27250","27250","0","0.00","752318","21069564950"
"069620","대웅제약","179500","179500","0","0.00","1127289","206958852500"
"007680","대원","8840","8870","30","0.34","312351","2710373810"
"000430","대원강업","2825","3195","370","13.10","5239446","17825673205"
"048910","대원미디어","12350","14600","2250","18.22","2262020","31236876200"
"005710","대원산업","5280","5460","180","3.41","253900","1350262430"
"006340","대원전선","1500","1570","70","4.67","7398702","11222489560"
"006345","대원전선우","2630","2795","165","6.27","102176","268669250"
"003220","대원제약","17500","18200","700","4.00","9847795","182894976000"
"024890","대원화성","2450","3240","790","32.24","73537026","237643836200"
"290380","대유","4495","4625","130","2.89","16474573","79402811345"
"002880","대유에이텍","841","890","49","5.83","6327569","5428623311"
"290120","대유에이피","5470","6320","850","15.54","898337","5427155530"
"000300","대유플러스","869","953","84","9.67","9322077","8521666615"
"120240","대정화금","18100","18750","650","3.59","1080769","20048320100"
"003310","대주산업","3310","2655","-655","-19.79","35143523","102350067190"
"114920","대주이엔티","1820","2390","570","31.32","1535","2711950"
"078600","대주전자재료","65600","87600","22000","33.54","4343141","332497973300"
"012800","대창","1400","1540","140","10.00","7215470","10425573390"
"015230","대창단조","5240","5480","240","4.58","3902019","19908908395"
"096350","대창솔루션","433","423","-10","-2.31","19517262","8220577854"
"140520","대창스틸","3270","3470","200","6.12","1226644","4076798940"
"131220","대한과학","7400","10050","2650","35.81","25726453","264213537610"
"010170","대한광통신","2200","3270","1070","48.64","30148818","84532081580"
"060900","대한그린파워","735","875","140","19.05","71792752","59709820000"
"054670","대한뉴팜","10200","10800","600","5.88","1277079","13338907720"
"001070","대한방직","49700","52600","2900","5.84","471738","23054163700"
"023910","대한약품","26100","27000","900","3.45","97153","2618395200"
"006650","대한유화","128500","130000","1500","1.17","710949","88561698000"
"001440","대한전선","1825","1850","25","1.37","223602726","386530756675"
"084010","대한제강","15300","16600","1300","8.50","990753","15567507900"
"001790","대한제당","3300","3000","-300","-9.09","16860181","52973681125"
"001795","대한제당우","3215","2930","-285","-8.86","4571762","14274058440"
"001130","대한제분","145000","142500","-2500","-1.72","70757","9869441500"
"003490","대한항공","25150","25850","700","2.78","30896060","777472512050"
"003495","대한항공우","33350","32550","-800","-2.40","104675","3476329550"
"005880","대한해운","2440","2495","55","2.25","19354981","45850765910"
"003830","대한화섬","106000","110500","4500","4.25","11999","1256640000"
"016090","대현","2100","2255","155","7.38","3654553","7776831525"
"069460","대호에이엘","2500","2140","-360","-14.40","60806787","135406303375"
"021040","대호특수강","632","743","111","17.56","1877812","1301300712"
"021045","대호특수강우","1320","1320","0","0.00","177731","237663400"
"067080","대화제약","7150","8100","950","13.29","843041","6390241670"
"298540","더네이쳐홀딩스","29600","28850","-750","-2.53","584765","17288997850"
"192080","더블유게임즈","40900","39900","-1000","-2.44","1196263","48672213700"
"299170","더블유에스아이","2040","2350","310","15.20","1230194","2719326370"
"012510","더존비즈온","36100","33200","-2900","-8.03","2357154","79097718350"
"302920","더콘텐츠온","9990","9990","0","0.00","72","684530"
"213420","덕산네오룩스","31200","31450","250","0.80","1989994","62980918200"
"317330","덕산테코피아","15650","16000","350","2.24","1068781","16792835800"
"077360","덕산하이메탈","7280","7080","-200","-2.75","5372450","40224399620"
"004830","덕성","6260","6200","-60","-0.96","2407118","15133468950"
"004835","덕성우","7260","7300","40","0.55","246715","1813426100"
"090410","덕신하우징","2240","2495","255","11.38","40038079","93460563235"
"024900","덕양산업","2480","2780","300","12.10","1432855","3813256620"
"263600","덕우전자","6270","7330","1060","16.91","11186201","82488375110"
"194480","데브시스터즈","45000","45550","550","1.22","3095811","149487388200"
"348840","데이드림엔터","10950","10500","-450","-4.11","0","0"
"263800","데이타솔루션","5490","5630","140","2.55","4509187","25071304700"
"199150","데이터스트림즈","11450","10250","-1200","-10.48","6231","62688350"
"206560","덱스터","14150","16400","2250","15.90","17542252","280610038650"
"261200","덴티스","8840","10100","1260","14.25","2155520","20469233240"
"145720","덴티움","84200","101500","17300","20.55","3386486","292513578200"
"227420","도부마스크","4080","3840","-240","-5.88","152444","570933720"
"067990","도이치모터스","8380","8240","-140","-1.67","7154321","59490815900"
"002150","도화엔지니어링","9450","9290","-160","-1.69","10182179","93776852310"
"006620","동구바이오제약","6520","6860","340","5.21","2026639","13749539250"
"100130","동국S&C","5530","7120","1590","28.75","59024042","399256797280"
"005160","동국산업","2855","3070","215","7.53","1157794","3385755560"
"075970","동국알앤에스","3790","4190","400","10.55","17259806","72931217490"
"001230","동국제강","12750","14100","1350","10.59","9172155","117922939000"
"086450","동국제약","19850","19700","-150","-0.76","1227332","23823222650"
"023450","동남합성","58400","59000","600","1.03","18820","1096216400"
"004140","동방","2780","2960","180","6.47","4978058","14546745410"
"099410","동방선기","3125","3480","355","11.36","2289785","7453395365"
"007590","동방아그로","6900","7240","340","4.93","267169","1876656000"
"005960","동부건설","10850","11800","950","8.76","799179","8644408750"
"005965","동부건설우","25700","28500","2800","10.89","8760","225298950"
"026960","동서","25700","25500","-200","-0.78","1075076","26878752050"
"002210","동성제약","7860","8050","190","2.42","654722","5172597340"
"102260","동성케미컬","4000","4470","470","11.75","627132","2662934715"
"033500","동성화인텍","10750","12400","1650","15.35","7426326","86483573500"
"025950","동신건설","20250","22600","2350","11.60","2677916","58568125100"
"000640","동아쏘시오홀딩스","102500","108500","6000","5.85","166237","17306773500"
"170900","동아에스티","58900","59600","700","1.19","113194","6909258100"
"088130","동아엘텍","7020","7390","370","5.27","197061","1416641080"
"028100","동아지질","16650","18650","2000","12.01","1044973","18521007900"
"282690","동아타이어","11600","12050","450","3.88","150964","1765086150"
"041930","동아화성","8060","9260","1200","14.89","2688867","23594584830"
"001520","동양","1150","1195","45","3.91","6660085","7811682705"
"001527","동양2우B","12400","13050","650","5.24","27131","343917250"
"084670","동양고속","15700","16600","900","5.73","16822","264728000"
"082640","동양생명","5600","5500","-100","-1.79","1566852","8508596880"
"060380","동양에스텍","2435","2755","320","13.14","13176862","36668228285"
"001525","동양우","6300","6340","40","0.63","51081","322064030"
"079960","동양이엔피","13600","14900","1300","9.56","459724","6588726250"
"008970","동양철관","1085","1170","85","7.83","34111699","38157298785"
"228340","동양파일","3625","3925","300","8.28","784101","2891600225"
"092780","동양피스톤","4880","5320","440","9.02","1007412","5076008640"
"088910","동우팜투테이블","2765","2925","160","5.79","2356734","6544741470"
"094170","동운아나텍","8490","8320","-170","-2.00","9447769","82022136780"
"049770","동원F&B","153500","163500","10000","6.51","62854","9894549000"
"013120","동원개발","4200","4220","20","0.48","2106101","8754028495"
"018500","동원금속","864","904","40","4.63","1783366","1583603172"
"006040","동원산업","214000","230000","16000","7.48","57611","12877067500"
"030720","동원수산","9250","10100","850","9.19","1796611","17823677010"
"014820","동원시스템즈","51900","58200","6300","12.14","642641","35484546150"
"014825","동원시스템즈우","31750","34150","2400","7.56","2681","87377700"
"163560","동일고무벨트","7930","7160","-770","-9.71","1993746","14546306500"
"109860","동일금속","18200","20150","1950","10.71","1213035","22876171400"
"032960","동일기연","11700","13300","1600","13.68","5041045","70979809550"
"004890","동일산업","169000","180000","11000","6.51","93190","16276826500"
"002690","동일제강","3245","3375","130","4.01","2528830","8164794730"
"023790","동일철강","2705","2790","85","3.14","689377","1854842770"
"005290","동진쎄미켐","33450","34250","800","2.39","15870460","557471790850"
"025900","동화기업","60900","73300","12400","20.36","1124062","73675276600"
"000020","동화약품","10500","10600","100","0.95","3305034","35912490650"
"000150","두산","68100","80900","12800","18.80","1649526","116957112300"
"000157","두산2우B","93500","101500","8000","8.56","33095","3173618900"
"241560","두산밥캣","29100","32600","3500","12.03","6489201","199863243400"
"034020","두산에너빌리티","18550","20350","1800","9.70","79303018","1469330246800"
"000155","두산우","45600","52200","6600","14.47","55539","2635872800"
"131970","두산테스나","30750","29250","-1500","-4.88","2949511","87357295450"
"336260","두산퓨얼셀","30000","38850","8850","29.50","8650247","283671914400"
"33626K","두산퓨얼셀1우","9460","13400","3940","41.65","1063271","12975895570"
"33626L","두산퓨얼셀2우B","12450","16100","3650","29.32","645513","9645814850"
"016740","두올","2760","2960","200","7.25","2451007","7115193770"
"073190","듀오백","2215","2770","555","25.06","1070131","2756556795"
"176750","듀켐바이오","7030","6700","-330","-4.69","136105","914238250"
"030350","드래곤플라이","1885","2095","210","11.14","29702722","61320923340"
"203650","드림시큐리티","3110","3370","260","8.36","11678722","39397497570"
"223250","드림씨아이에스","14050","14250","200","1.42","751981","10611142350"
"060570","드림어스컴퍼니","3300","3690","390","11.82","1030177","3566941890"
"192650","드림텍","9570","9240","-330","-3.45","3613679","33580969410"
"217620","디딤","1375","1385","10","0.73","8854311","13030674272"
"016670","디모아","973","973","0","0.00","0","0"
"187870","디바이스이엔지","17200","18400","1200","6.98","219529","3976249550"
"066670","디스플레이텍","5950","6180","230","3.87","6391346","40662168470"
"024090","디씨엠","22350","20500","-1850","-8.28","1069650","22788311700"
"003160","디아이","5910","6210","300","5.08","1595129","10016139650"
"092200","디아이씨","4125","4485","360","8.73","2532943","10935248905"
"110990","디아이티","7170","7070","-100","-1.39","1600772","11966236250"
"078590","디아크","2380","2380","0","0.00","0","0"
"263690","디알젬","8710","9640","930","10.68","176455","1648402750"
"214680","디알텍","1525","1655","130","8.52","9278630","14360899360"
"377190","디앤디플랫폼리츠","4410","4645","235","5.33","2763696","11913636690"
"263720","디앤씨미디어","21700","23000","1300","5.99","956366","22096779950"
"376300","디어유","34750","37250","2500","7.19","3726981","140782890350"
"141020","디에스앤엘","1335","1335","0","0.00","0","0"
"109740","디에스케이","5190","5770","580","11.18","344177","1906905210"
"196490","디에이테크놀로지","3930","4680","750","19.08","4523395","19156931725"
"066900","디에이피","3310","3495","185","5.59","867161","2988547790"
"180400","디엑스앤브이엑스","7740","7740","0","0.00","0","0"
"127120","디엔에이링크","3975","3925","-50","-1.26","1542022","5937462830"
"092070","디엔에프","14550","14000","-550","-3.78","1074968","15832018600"
"039840","디오","26700","27650","950","3.56","1041014","28259496900"
"013570","디와이","6850","7350","500","7.30","6525432","46379439670"
"219550","디와이디","1435","1530","95","6.62","25556209","39186008465"
"310870","디와이씨","1450","1590","140","9.66","3861920","5963038505"
"210540","디와이파워","12650","12600","-50","-0.40","1321219","15671542600"
"104460","디와이피엔에프","38500","40400","1900","4.94","481118","18404281000"
"079810","디이엔티","6780","7940","1160","17.11","1361409","10181203340"
"113810","디젠스","1100","1250","150","13.64","34867869","45152913499"
"043360","디지아이","3600","3430","-170","-4.72","1402713","4986270250"
"197140","디지캡","4045","4125","80","1.98","1246032","4966750495"
"068930","디지털대성","6940","7910","970","13.98","894704","6459998580"
"033130","디지틀조선","2180","2325","145","6.65","1972762","4459958035"
"105740","디케이락","9440","12150","2710","28.71","1472694","15611244750"
"263020","디케이앤디","2955","3160","205","6.94","1024655","3160037200"
"290550","디케이티","9240","11000","1760","19.05","1741287","18321533800"
"187220","디티앤씨","5040","5630","590","11.71","2359068","13124671540"
"163430","디피코","7620","7620","0","0.00","0","0"
"131180","딜리","1660","1675","15","0.90","1368965","2250582340"
"315640","딥노이드","8180","8700","520","6.36","1263449","11182109240"
"317120","라닉스","6200","6760","560","9.03","1457301","9690139900"
"042510","라온시큐어","2745","3055","310","11.29","11330708","33685943385"
"232680","라온테크","14700","14650","-50","-0.34","2557669","37698066950"
"300120","라온피플","7132","5800","-1332","-18.68","7013726","65874094690"
"171120","라이온켐텍","7600","8950","1350","17.76","11298049","105127349320"
"069540","라이트론","3880","4250","370","9.54","1667063","6585392580"
"285770","라이프사이언스테크놀로지","1390","1390","0","0.00","0","0"
"347700","라이프시맨틱스","5700","5950","250","4.39","2178340","13212262450"
"214260","라파스","38600","40700","2100","5.44","613871","24845759200"
"403360","라피치","13000","13500","500","3.85","1488","18975600"
"115390","락앤락","7810","8070","260","3.33","4575868","39972520970"
"200350","래몽래인","16100","22050","5950","36.96","4571213","89736075100"
"171010","램테크놀러지","6190","7410","1220","19.71","5720128","40681663630"
"084650","랩지노믹스","7590","8100","510","6.72","93337802","824718600940"
"217500","러셀","3490","3820","330","9.46","10681263","40843373375"
"092590","럭스피아","2350","2085","-265","-11.28","25943","48196140"
"141080","레고켐바이오","47950","50100","2150","4.48","5253340","245473397650"
"060300","레드로버","1830","1830","0","0.00","0","0"
"038390","레드캡투어","18350","20350","2000","10.90","434773","8858675250"
"294140","레몬","5920","5420","-500","-8.45","12067860","68687862330"
"228670","레이","23950","23100","-850","-3.55","2948307","71112509900"
"228850","레이언스","9500","10800","1300","13.68","960508","10044594290"
"412350","레이저쎌","14750","12350","-2400","-16.27","11646741","150168041040"
"281740","레이크머티리얼즈","4450","4710","260","5.84","9351985","45124102325"
"277810","레인보우로보틱스","23750","28150","4400","18.53","10601974","295757127100"
"179720","렌딩머신","5600","5100","-500","-8.93","165","967400"
"215100","로보로보","7300","7770","470","6.44","19360933","150189966900"
"090360","로보스타","18500","20650","2150","11.62","2214847","44145276350"
"238500","로보쓰리","798","720","-78","-9.77","971148","687364840"
"108490","로보티즈","18150","21700","3550","19.56","8744966","186844139150"
"900260","로스웰","307","355","48","15.64","213763707","79042935760"
"223220","로지스몬","598","590","-8","-1.34","3159","1509486"
"067730","로지시스","4950","5840","890","17.98","6695874","40650891490"
"071280","로체시스템즈","6020","6380","360","5.98","2325312","14544142270"
"032350","롯데관광개발","11900","11850","-50","-0.42","8656871","98466667350"
"089860","롯데렌탈","36650","38100","1450","3.96","1520587","58454143600"
"330590","롯데리츠","5290","5080","-210","-3.97","5510934","27860310133"
"000400","롯데손해보험","1615","1705","90","5.57","3675175","6146930080"
"023530","롯데쇼핑","99000","102000","3000","3.03","2142602","202292682400"
"004000","롯데정밀화학","68800","68500","-300","-0.44","3406575","224018928600"
"286940","롯데정보통신","26350","27550","1200","4.55","552919","14919253850"
"280360","롯데제과","115500","122500","7000","6.06","247919","29292049500"
"004990","롯데지주","35050","38850","3800","10.84","3801543","136281071500"
"00499K","롯데지주우","47600","50700","3100","6.51","20902","1014178100"
"005300","롯데칠성","174000","166500","-7500","-4.31","893741","151828490500"
"005305","롯데칠성우","71900","71200","-700","-0.97","25647","1824293400"
"011170","롯데케미칼","180000","183000","3000","1.67","2375109","412273298500"
"071840","롯데하이마트","16850","16700","-150","-0.89","412397","6959573050"
"038060","루멘스","1135","1190","55","4.85","3335361","3897344270"
"162120","루켄테크놀러지스","4800","5100","300","6.25","42518","203993190"
"253610","루트락","2395","2290","-105","-4.38","20701","42295815"
"085370","루트로닉","17900","20700","2800","15.64","7335041","140383140350"
"08537M","루트로닉3우C","25200","28850","3650","14.48","4168","107938600"
"060240","룽투코리아","4765","5280","515","10.81","32338656","173653572145"
"058470","리노공업","134200","131500","-2700","-2.01","1016682","133369511164"
"039980","리노스","1030","972","-58","-5.63","7484113","7114926366"
"019570","리더스 기술투자","400","387","-13","-3.25","12887535","5101464693"
"016100","리더스코스메틱","2820","2630","-190","-6.74","346680","933920380"
"012700","리드코프","8080","8430","350","4.33","2700440","22432369880"
"302550","리메드","13400","13550","150","1.12","458887","6406228200"
"377450","리파인","11500","11000","-500","-4.35","855502","9482142900"
"277070","린드먼아시아","4720","5060","340","7.20","4352301","22642504025"
"042500","링네트","4550","5020","470","10.33","5081582","27520855105"
"219420","링크제니시스","5680","7020","1340","23.59","9647354","68456740510"
"027740","마니커","1585","1410","-175","-11.04","10178805","14588048475"
"195500","마니커에프앤지","3915","4110","195","4.98","4041306","16589720725"
"357430","마스턴프리미어리츠","5010","5010","0","0.00","336286","1664800630"
"222810","마이더스AI","2070","1570","-500","-24.15","58932447","118544151900"
"305090","마이크로디지탈","5140","5330","190","3.70","1655249","9506204920"
"098120","마이크로컨텍솔","6300","6440","140","2.22","1262995","8139284250"
"147760","마이크로프랜드","4550","4935","385","8.46","396342","1935886675"
"377480","마인즈랩","16250","17000","750","4.62","1450480","24454071450"
"038290","마크로젠","26200","26850","650","2.48","318032","8344388000"
"204320","만도","48500","56200","7700","15.88","7270411","393601240300"
"001080","만호제강","22300","27600","5300","23.77","198513","4821842650"
"267980","매일유업","59100","59200","100","0.17","230577","13501374900"
"005990","매일홀딩스","9230","8900","-330","-3.58","102393","918905730"
"127160","매직마이크로","282","282","0","0.00","0","0"
"093520","매커스","7940","8980","1040","13.10","3227244","28381944970"
"377030","맥스트","17850","18850","1000","5.60","11710998","218464709050"
"088980","맥쿼리인프라","12200","12850","650","5.33","20356665","252899639500"
"094800","맵스리얼티1","4520","4510","-10","-0.22","796914","3536338160"
"100590","머큐리","6430","6660","230","3.58","380001","2493861140"
"067280","멀티캠퍼스","38100","40150","2050","5.38","161595","6540755300"
"072870","메가스터디","11200","11250","50","0.45","1501300","17371705550"
"215200","메가스터디교육","77400","85400","8000","10.34","1479586","127018953100"
"133750","메가엠디","2670","3120","450","16.85","57510603","210468294435"
"235980","메드팩토","26400","32250","5850","22.16","5298903","160610368150"
"200580","메디쎄이","14000","16400","2400","17.14","82733","1189745900"
"041920","메디아나","5100","5050","-50","-0.98","12369504","68723201345"
"233250","메디안디노스틱","32600","32700","100","0.31","267","8364050"
"014100","메디앙스","4160","4085","-75","-1.80","561506","2266702940"
"236340","메디젠휴먼케어","9400","9080","-320","-3.40","4828","43737760"
"054180","메디콕스","5410","8280","2870","53.05","16405336","124502998620"
"086900","메디톡스","113800","109900","-3900","-3.43","477967","54135598900"
"078160","메디포스트","19450","21300","1850","9.51","3567934","76624625850"
"065650","메디프론","1595","1725","130","8.15","2100310","3565813865"
"138040","메리츠금융지주","26600","29150","2550","9.59","3002171","78303429200"
"008560","메리츠증권","4665","4875","210","4.50","16071841","74386247995"
"000060","메리츠화재","32550","37250","4700","14.44","3584383","120601048550"
"021880","메이슨캐피탈","566","475","-91","-16.08","28401431","14289431559"
"140410","메지온","19600","18600","-1000","-5.10","10109346","212823521800"
"241770","메카로","10550","11500","950","9.00","194211","2100239510"
"090370","메타랩스","871","729","-142","-16.30","9090707","6982432977"
"059210","메타바이오메드","2270","2450","180","7.93","2213691","5291935755"
"058110","멕아이씨에스","6090","6390","300","4.93","29568187","211550547130"
"096640","멜파스","1495","1495","0","0.00","0","0"
"017180","명문제약","3270","3455","185","5.66","1305745","4383325515"
"257370","명성티엔에스","9210","9210","0","0.00","0","0"
"009900","명신산업","16650","22350","5700","34.23","11901771","240108077350"
"267060","명진홀딩스","181","181","0","0.00","0","0"
"012690","모나리자","3495","3480","-15","-0.43","6969983","24162899540"
"005360","모나미","4165","3800","-365","-8.76","12795829","48020646280"
"080420","모다이노칩","3405","3405","0","0.00","5214871","17641219010"
"080160","모두투어","15650","16100","450","2.88","1620623","24564316800"
"204210","모두투어리츠","4560","4875","315","6.91","89919","423268470"
"100030","모바일리더","20750","21300","550","2.65","197826","4088123350"
"087260","모바일어플라이언스","3165","3415","250","7.90","21133157","73383158190"
"101330","모베이스","2920","3190","270","9.25","2224778","6888871560"
"012860","모베이스전자","1395","1510","115","8.24","24139742","36446013785"
"363260","모비데이즈","1515","1490","-25","-1.65","20618203","32760593495"
"348030","모비릭스","15100","18300","3200","21.19","22771282","421017400000"
"250060","모비스","1740","2440","700","40.23","44963449","110631174565"
"288980","모아데이타","3843","2375","-1468","-38.20","64639176","411786466920"
"033200","모아텍","5610","9600","3990","71.12","27198719","250225584130"
"009680","모토닉","8480","8510","30","0.35","241153","2068266560"
"118990","모트렉스","10850","12000","1150","10.60","27735555","329294837640"
"006920","모헨즈","3960","4580","620","15.66","5163773","23028105915"
"009580","무림P&P","3970","4725","755","19.02","6951588","30299518385"
"001810","무림SP","2690","3000","310","11.52","11832433","35917466525"
"009200","무림페이퍼","2590","2740","150","5.79","21863125","61953415925"
"135160","무송지오씨","2660","2595","-65","-2.44","136763","346585525"
"322970","무진메디","5010","4990","-20","-0.40","54988","271801745"
"033920","무학","6680","7010","330","4.94","2347707","16523383920"
"008420","문배철강","3620","3885","265","7.32","3744801","14250134905"
"279600","미디어젠","10450","9910","-540","-5.17","172126","1713901090"
"095500","미래나노텍","6030","9070","3040","50.41","81296431","684372275410"
"025560","미래산업","10100","11300","1200","11.88","578929","6307695750"
"218150","미래생명자원","6500","5910","-590","-9.08","16808553","105973912440"
"007120","미래아이앤지","314","348","34","10.83","47009474","17192965959"
"396690","미래에셋글로벌리츠","4775","4895","120","2.51","993126","4680787460"
"353490","미래에셋대우스팩 5호","2150","2120","-30","-1.40","2888725","6548764440"
"328380","미래에셋대우스팩3호","2130","2255","125","5.87","19782427","48158855235"
"357250","미래에셋맵스리츠","4275","4405","130","3.04","668149","2843953880"
"100790","미래에셋벤처투자","5650","6160","510","9.03","2160629","12906275470"
"412930","미래에셋비전스팩1호","2150","2125","-25","-1.16","732986","1562875150"
"085620","미래에셋생명","3115","3145","30","0.96","1099361","3359681020"
"006800","미래에셋증권","6470","6690","220","3.40","22399696","143109295540"
"00680K","미래에셋증권2우B","3785","3935","150","3.96","2356374","9022859690"
"006805","미래에셋증권우","4350","4885","535","12.30","186082","842892655"
"208890","미래엔에듀파트너","1485","1300","-185","-12.46","1315","1618195"
"049950","미래컴퍼니","19550","21850","2300","11.76","475234","9810155100"
"207760","미스터블루","5440","6300","860","15.81","4439275","28008955510"
"002840","미원상사","175000","179000","4000","2.29","30661","5482598500"
"268280","미원에스씨","198000","193000","-5000","-2.53","30782","5964773000"
"107590","미원홀딩스","132500","136500","4000","3.02","10679","1418537500"
"134380","미원화학","66100","66800","700","1.06","5926","391732200"
"003650","미창석유","81600","82600","1000","1.23","9725","781664600"
"059090","미코","8190","9090","900","10.99","1721075","14967761070"
"214610","미코바이오메드","12200","11200","-1000","-8.20","76978780","1024725010150"
"201490","미투온","4425","4870","445","10.06","4214274","20158561990"
"950190","미투젠","16300","15950","-350","-2.15","840326","14136451100"
"155900","바다로19호","3340","3345","5","0.15","452359","1512957255"
"206640","바디텍메드","12950","12350","-600","-4.63","6069940","84787873000"
"018700","바른손","2695","3030","335","12.43","27390003","83094521740"
"035620","바른손이앤에이","1055","1160","105","9.95","7310913","8243592490"
"064520","바른전자","7000","5490","-1510","-21.57","1732755","9716253730"
"053030","바이넥스","15100","15400","300","1.99","6638181","100688402700"
"301300","바이브컴퍼니","30500","32550","2050","6.72","476116","14928311650"
"064550","바이오니아","34150","33300","-850","-2.49","44172361","1656785454950"
"314930","바이오다인","27200","27950","750","2.76","233013","6555374750"
"208710","바이오로그디바이스","1430","1310","-120","-8.39","23374091","33798420355"
"086820","바이오솔루션","15050","15050","0","0.00","749691","11573755950"
"038460","바이오스마트","4000","4355","355","8.88","12558668","58577466135"
"281310","바이오시네틱스","7600","7600","0","0.00","0","0"
"251120","바이오에프디엔씨","24200","23350","-850","-3.51","1237603","28045207950"
"266470","바이오인프라생명과학","2110","1600","-510","-24.17","233277","419709040"
"086040","바이오톡스텍","7660","8370","710","9.27","16394136","145059612810"
"199290","바이오프로테크","1085","1060","-25","-2.30","5325","5150761"
"099430","바이오플러스","30500","31650","1150","3.77","13899216","439415751393"
"032980","바이온","1350","1210","-140","-10.37","3231797","3765845040"
"222160","바이옵트로","6520","6590","70","1.07","1983962","13400939770"
"308080","바이젠셀","9310","9530","220","2.36","5215409","51007028600"
"043150","바텍","30350","35300","4950","16.31","1023466","33763746550"
"323990","박셀바이오","40400","65300","24900","61.63","36365670","2207506236950"
"003610","방림","2925","3740","815","27.86","5420679","17681003190"
"267790","배럴","7940","7830","-110","-1.39","912828","7284045860"
"001340","백광산업","4290","4735","445","10.37","20390383","91492940805"
"046310","백금T&A","2830","3015","185","6.54","1489177","4213835185"
"035150","백산","9310","10100","790","8.49","6318847","62625892280"
"066410","버킷스튜디오","2005","3185","1180","58.85","609569095","1707500168685"
"002410","범양건영","4650","5410","760","16.34","33325896","172696647975"
"382900","범한퓨얼셀","33900","33650","-250","-0.74","8142105","256088211000"
"206400","베노홀딩스","3405","3455","50","1.47","1816213","6383534310"
"019010","베뉴지","2295","2250","-45","-1.96","9070362","20259461335"
"322190","베른","553","664","111","20.07","65822","36941956"
"177350","베셀","6790","7950","1160","17.08","21142224","158847943380"
"299910","베스파","3165","3165","0","0.00","0","0"
"096300","베트남개발1","205","209","4","1.95","1242929","256221804"
"007210","벽산","2735","2960","225","8.23","12020533","34131461265"
"225530","보광산업","6610","7030","420","6.35","19033278","132188676960"
"250000","보라티알","12000","12900","900","7.50","2808716","36679334050"
"002760","보락","1695","1765","70","4.13","3759771","6566986995"
"003850","보령","10350","11150","800","7.73","2855268","31087455600"
"310210","보로노이","48000","41250","-6750","-14.06","9786554","417421624650"
"006910","보성파워텍","5550","5710","160","2.88","33021220","177859338620"
"000890","보해양조","726","774","48","6.61","6379850","4773037043"
"226340","본느","1680","1740","60","3.57","2407296","4193785740"
"206950","볼빅","2950","3200","250","8.47","5849","18506740"
"003000","부광약품","8670","9740","1070","12.34","40266581","390796241510"
"001270","부국증권","21250","22600","1350","6.35","23332","496863600"
"001275","부국증권우","20200","20200","0","0.00","20624","412777950"
"026940","부국철강","3610","3985","375","10.39","2451795","9243171490"
"014470","부방","2250","2330","80","3.56","3142789","7171299660"
"011390","부산산업","86600","88900","2300","2.66","88482","7708482000"
"005030","부산주공","890","810","-80","-8.99","65879272","55264989391"
"008470","부스타","5200","5420","220","4.23","262405","1373410840"
"338220","뷰노","8120","7760","-360","-4.43","2137763","16651193390"
"100120","뷰웍스","34650","43200","8550","24.68","854047","34397513000"
"337930","브랜드엑스코퍼레이션","7280","8200","920","12.64","2065201","16335644220"
"099390","브레인즈컴퍼니","8520","8840","320","3.76","736224","6652346510"
"064480","브리지텍","4845","5490","645","13.31","1558911","8023900440"
"288330","브릿지바이오테라퓨틱스","9080","12600","3520","38.77","3336224","39658505740"
"365900","브이씨","12600","10550","-2050","-16.27","3013204","35221954950"
"251630","브이원텍","7400","7810","410","5.54","882632","6821487780"
"018290","브이티지엠피","5270","5470","200","3.80","3407493","18627747270"
"044480","블루베리 NFT","2455","2185","-270","-11.00","17653283","42903950035"
"033560","블루콤","9880","9720","-160","-1.62","374190","3644619140"
"191600","블루탑","6930","9670","2740","39.54","1003","7706250"
"369370","블리츠웨이","2810","3105","295","10.50","5758371","16966159145"
"126340","비나텍","41450","45650","4200","10.13","621582","25821060550"
"121800","비덴트","8920","10600","1680","18.83","166406892","1949828028240"
"148140","비디아이","640","640","0","0.00","0","0"
"082800","비보존 헬스케어","959","1000","41","4.28","8390765","8417527887"
"318410","비비씨","10700","11250","550","5.14","562892","6331373700"
"002070","비비안","1730","1945","215","12.43","12001562","23686549675"
"100220","비상교육","6120","6500","380","6.21","1870369","12490753260"
"146320","비씨엔씨","17000","17100","100","0.59","1644779","28224410900"
"200780","비씨월드제약","10200","10900","700","6.86","1347384","15287725750"
"141000","비아트론","8320","9030","710","8.53","786120","6971786730"
"090460","비에이치","25500","28250","2750","10.78","16703613","455720553300"
"083650","비에이치아이","7600","8390","790","10.39","22759992","168078185670"
"215050","비엔디생활건강","912","912","0","0.00","0","0"
"142760","비엘","6110","6240","130","2.13","26490700","197068198020"
"065170","비엘팜텍","936","920","-16","-1.71","3916724","3708034113"
"086220","비엘헬스케어","2585","2750","165","6.38","852","2246560"
"086670","비엠티","12050","16350","4300","35.68","4154832","61184527550"
"335890","비올","2000","2070","70","3.50","4752839","9793414805"
"138580","비즈니스온","8060","8330","270","3.35","653549","5348107100"
"082920","비츠로셀","11150","13350","2200","19.73","1691020","20951342350"
"054220","비츠로시스","5640","2360","-3280","-58.16","41030022","120078320180"
"042370","비츠로테크","7050","7120","70","0.99","1503481","10580270310"
"030790","비케이탑스","904","904","0","0.00","0","0"
"050090","비케이홀딩스","520","572","52","10.00","20660981","11986855109"
"307870","비투엔","2050","2255","205","10.00","33415832","91895034415"
"357880","비트나인","12000","11300","-700","-5.83","4295996","49887402850"
"032850","비트컴퓨터","6620","7260","640","9.67","7008949","51782237900"
"148780","비플라이소프트","2140","2150","10","0.47","28910100","216103687960"
"238200","비피도","8380","8350","-30","-0.36","393920","3225585570"
"093190","빅솔론","6100","6900","800","13.11","1193309","8119037280"
"065450","빅텍","5340","6040","700","13.11","23729419","138795358555"
"210120","빅텐츠","18950","20400","1450","7.65","1577","29115900"
"005180","빙그레","46650","47050","400","0.86","159178","7522964500"
"072950","빛샘전자","6550","7170","620","9.47","583363","4073287230"
"266170","뿌리깊은나무들","1430","1080","-350","-24.48","141577","135893991"
"143240","사람인에이치알","33100","33650","550","1.66","729781","24026665150"
"003960","사조대림","24600","26250","1650","6.71","392240","9635120500"
"008040","사조동아원","1600","1355","-245","-15.31","59254136","85326431105"
"007160","사조산업","45200","45150","-50","-0.11","169947","7588282750"
"014710","사조씨푸드","5160","5790","630","12.21","20269264","120212797185"
"006090","사조오양","9120","9340","220","2.41","350084","3176966950"
"100090","삼강엠앤티","19450","27100","7650","39.33","14994633","348656185400"
"122350","삼기","3120","3505","385","12.34","4075988","13992397540"
"014970","삼륭물산","5960","6810","850","14.26","8623879","57288188020"
"018310","삼목에스폼","18700","21750","3050","16.31","1050534","20974923650"
"053700","삼보모터스","4000","4810","810","20.25","6222308","31483011470"
"009620","삼보산업","1105","1280","175","15.84","11642560","14179475410"
"023600","삼보판지","9540","10150","610","6.39","598056","5863357710"
"001470","삼부토건","2160","2170","10","0.46","102306439","214421187855"
"006400","삼성SDI","537000","617000","80000","14.90","5452323","3102695883765"
"006405","삼성SDI우","274000","310000","36000","13.14","45905","13456764000"
"006660","삼성공조","10600","10600","0","0.00","207248","2184941050"
"380320","삼성머스트스팩5호","4490","4975","485","10.80","30855122","150873011175"
"028260","삼성물산","114000","123500","9500","8.33","5392758","634037728000"
"02826K","삼성물산우B","103500","112000","8500","8.21","65431","7143135000"
"207940","삼성바이오로직스","819000","904000","85000","10.38","1256998","1070343725300"
"032830","삼성생명","60200","62300","2100","3.49","4046935","241115659970"
"377630","삼성스팩4호","6020","8370","2350","39.04","81840087","629080542720"
"425290","삼성스팩6호","7560","6530","-1030","-13.62","46617519","319940052290"
"018260","삼성에스디에스","132500","131500","-1000","-0.75","2461865","326041446500"
"028050","삼성엔지니어링","20550","21800","1250","6.08","24858795","489932546250"
"009150","삼성전기","134500","134500","0","0.00","10985775","1525861984654"
"009155","삼성전기우","74800","76800","2000","2.67","104096","8114522800"
"005930","삼성전자","58700","59900","1200","2.04","299216347","18093788591826"
"005935","삼성전자우","53900","54700","800","1.48","18864701","1047147784361"
"001360","삼성제약","3330","3860","530","15.92","18360014","72834140270"
"010140","삼성중공업","5500","5970","470","8.55","74840170","418221618270"
"010145","삼성중공우","229500","231000","1500","0.65","8909","2017204000"
"016360","삼성증권","33650","35350","1700","5.05","5807531","193605736750"
"068290","삼성출판사","25550","27800","2250","8.81","1534211","41298465300"
"029780","삼성카드","30500","31750","1250","4.10","1546597","48091688268"
"000810","삼성화재","196500","202500","6000","3.05","1569179","312060988225"
"000815","삼성화재우","156000","158500","2500","1.60","114508","18002019000"
"006110","삼아알미늄","16900","23050","6150","36.39","5251894","112142575150"
"009300","삼아제약","14750","15400","650","4.41","230636","3527305450"
"145990","삼양사","41350","42600","1250","3.02","218792","9072436500"
"145995","삼양사우","32800","34900","2100","6.40","3647","124906100"
"003230","삼양식품","102500","111000","8500","8.29","1615462","172744653500"
"225190","삼양옵틱스","12650","12350","-300","-2.37","446831","5424951050"
"002170","삼양통상","53400","53300","-100","-0.19","27342","1445277500"
"272550","삼양패키징","17150","19750","2600","15.16","176595","3326663250"
"000070","삼양홀딩스","73500","74600","1100","1.50","300972","22046849600"
"000075","삼양홀딩스우","60000","59600","-400","-0.67","709","42352900"
"002810","삼영무역","13350","13600","250","1.87","101990","1378810650"
"361670","삼영에스앤씨","7000","7560","560","8.00","283102","2120745210"
"054540","삼영엠텍","5450","5820","370","6.79","43123932","232365670425"
"065570","삼영이엔씨","4890","7510","2620","53.58","17659412","109979351270"
"005680","삼영전자","10350","10500","150","1.45","564174","5862557650"
"003720","삼영화학","2475","3285","810","32.73","38443355","118831081315"
"023000","삼원강재","2580","2820","240","9.30","642857","1804924140"
"004380","삼익THK","12150","13850","1700","13.99","2342137","31870794300"
"002450","삼익악기","1410","1550","140","9.93","6509478","10315362550"
"032280","삼일","2155","2410","255","11.83","2577045","5886582230"
"002290","삼일기업공사","3720","4640","920","24.73","16709228","78212450315"
"004440","삼일씨엔에스","7540","9150","1610","21.35","1014894","9392447110"
"000520","삼일제약","7800","8100","300","3.85","2999406","24713359230"
"009770","삼정펄프","26250","29700","3450","13.14","1262618","36874121650"
"037460","삼지전자","9830","10200","370","3.76","508108","5175228330"
"032750","삼진","6750","7340","590","8.74","3479646","27804098320"
"054090","삼진엘앤디","3400","3450","50","1.47","70925517","243906413735"
"005500","삼진제약","24550","24450","-100","-0.41","2324799","58246828100"
"000250","삼천당제약","32650","36750","4100","12.56","3306310","116861807300"
"004690","삼천리","182000","194500","12500","6.87","603671","112078555500"
"024950","삼천리자전거","7680","7950","270","3.52","2231477","17254626970"
"038500","삼표시멘트","4050","4450","400","9.88","8654241","38266606775"
"017480","삼현철강","5500","5870","370","6.73","781600","4309914330"
"010960","삼호개발","3980","4280","300","7.54","975013","4019144905"
"046390","삼화네트웍스","3630","3860","230","6.34","18684256","69418471585"
"004450","삼화왕관","37050","42400","5350","14.44","995124","44101750850"
"009470","삼화전기","18250","19200","950","5.21","193055","3587853000"
"011230","삼화전자","2965","3050","85","2.87","407929","1240378555"
"001820","삼화콘덴서","39700","42550","2850","7.18","545815","23056184100"
"000390","삼화페인트","6690","8280","1590","23.77","4133031","33927605000"
"027580","상보","1495","1640","145","9.70","27501759","46238356295"
"038540","상상인","8740","9150","410","4.69","2934857","25841709930"
"101000","상상인인더스트리","747","794","47","6.29","17798512","15146073014"
"415580","상상인제3호스팩","2115","2105","-10","-0.47","376395","791770005"
"001290","상상인증권","960","1055","95","9.90","9717702","11084703767"
"041650","상신브레이크","3260","3400","140","4.29","415997","1404328510"
"091580","상신이디피","15900","18750","2850","17.92","8821735","157109889250"
"263810","상신전자","3370","3495","125","3.71","2013973","7060024440"
"089980","상아프론테크","29650","34300","4650","15.68","1229797","38867457000"
"042940","상지카일룸","1005","1030","25","2.49","17066358","17931738607"
"042600","새로닉스","20400","23750","3350","16.42","1387832","30770997050"
"075180","새론오토모티브","4830","4945","115","2.38","55071","269806940"
"252990","샘씨엔에스","5040","5000","-40","-0.79","5742897","29421490900"
"007540","샘표","57500","51700","-5800","-10.09","1094216","59424362050"
"248170","샘표식품","36000","38700","2700","7.50","1030158","41132803800"
"294630","서남","2730","2985","255","9.34","1472778","4216927185"
"038070","서린바이오","12650","16100","3450","27.27","31393329","536360295450"
"006730","서부T&D","7310","8590","1280","17.51","7798262","61899981750"
"079650","서산","2025","2195","170","8.40","1020646","2241388280"
"100660","서암기계공업","7680","6920","-760","-9.90","21733253","157719403230"
"007860","서연","7250","6950","-300","-4.14","2125344","15020088480"
"200880","서연이화","8130","8730","600","7.38","10241793","90649939780"
"019770","서연탑메탈","6330","5920","-410","-6.48","4430332","26262995910"
"017390","서울가스","243000","251000","8000","3.29","305113","73762584500"
"043710","서울리거","1025","956","-69","-6.73","2090408","2063323419"
"092190","서울바이오시스","7040","6960","-80","-1.14","5359402","39920628230"
"046890","서울반도체","10600","11250","650","6.13","3384346","36919130300"
"004410","서울식품","258","265","7","2.71","129813607","35378855974"
"004415","서울식품우","3230","3380","150","4.64","101825","347134425"
"063170","서울옥션","18800","23500","4700","25.00","7040913","145362005050"
"027040","서울전자통신","692","700","8","1.16","2000633","1329864349"
"018680","서울제약","4980","5310","330","6.63","3335680","20088739685"
"021050","서원","1410","1520","110","7.80","2512404","3601782595"
"093920","서원인텍","5650","5830","180","3.19","542383","3117667640"
"189860","서전기전","9440","9870","430","4.56","5591978","52389933840"
"178320","서진시스템","15150","15900","750","4.95","3500234","54159675750"
"122690","서진오토모티브","3085","3165","80","2.59","998536","3096600660"
"140070","서플러스글로벌","3400","3730","330","9.71","1773202","6391534335"
"011370","서한","1345","1485","140","10.41","12827337","18093017915"
"065710","서호전기","17850","18850","1000","5.60","89511","1655882550"
"008490","서흥","32200","36250","4050","12.58","245806","8453421800"
"035890","서희건설","1420","1515","95","6.69","11929338","17004805115"
"357550","석경에이티","17300","19100","1800","10.40","1844957","33905869550"
"003100","선광","90400","99200","8800","9.73","1035093","97817429900"
"007610","선도전기","3000","3000","0","0.00","0","0"
"067370","선바이오","17350","18300","950","5.48","102491","1778274850"
"171090","선익시스템","16400","17850","1450","8.84","3506603","61795868150"
"136490","선진","10150","11250","1100","10.84","1692180","17637986890"
"086710","선진뷰티사이언스","5940","6560","620","10.44","1583285","9977036800"
"014620","성광벤드","11050","14550","3500","31.67","14014854","170330570150"
"037350","성도이엔지","5200","5540","340","6.54","2469005","13008608495"
"014910","성문전자","1800","2035","235","13.06","4013456","7989062210"
"014915","성문전자우","8240","8750","510","6.19","12890","109333800"
"003080","성보화학","3590","3745","155","4.32","2415204","8721081105"
"004980","성신양회","9450","10550","1100","11.64","4961043","50570910540"
"004985","성신양회우","13350","15150","1800","13.48","1006321","16241646650"
"011300","성안","593","1085","492","82.97","159450449","157668534613"
"081580","성우전자","2905","3040","135","4.65","678640","1997204935"
"045300","성우테크론","4660","5060","400","8.58","4880721","24439876225"
"015750","성우하이텍","4370","5390","1020","23.34","41544566","225579529525"
"000180","성창기업지주","2000","2205","205","10.25","6557599","14002238955"
"080470","성창오토텍","6810","7510","700","10.28","603196","4452936840"
"043260","성호전자","1505","1490","-15","-1.00","8250071","12623276690"
"148150","세경하이테크","17000","19700","2700","15.88","1556183","30184479100"
"002420","세기상사","8360","9610","1250","14.95","674789","6473055890"
"053060","세동","1395","1595","200","14.34","11621369","17777751525"
"340440","세림B&G","4040","3835","-205","-5.07","182873796","717490497970"
"017510","세명전기","3920","3925","5","0.13","904047","3447282560"
"004360","세방","10350","12950","2600","25.12","982509","11334461220"
"004365","세방우","6830","7070","240","3.51","21259","147928330"
"004490","세방전지","50900","55000","4100","8.06","872976","46014074950"
"011560","세보엠이씨","8230","8610","380","4.62","1497767","12206172830"
"396300","세아메카닉스","6860","7770","910","13.27","65759139","496875047330"
"001430","세아베스틸지주","15100","15600","500","3.31","885654","13181804150"
"306200","세아제강","151000","174500","23500","15.56","530386","84825807000"
"003030","세아제강지주","128000","160500","32500","25.39","500284","73512377000"
"019440","세아특수강","14050","14200","150","1.07","174081","2397565250"
"058650","세아홀딩스","95800","102500","6700","6.99","3911","382345900"
"013000","세우글로벌","1640","1690","50","3.05","2603642","4271501210"
"100700","세운메디칼","3280","3510","230","7.01","10658597","38166699485"
"024830","세원물산","6280","6280","0","0.00","0","0"
"091090","세원이앤씨","636","845","209","32.86","77978822","64398857356"
"021820","세원정공","8090","8090","0","0.00","0","0"
"067830","세이브존I&C","2895","2900","5","0.17","699919","2044280195"
"033530","세종공업","5390","6180","790","14.66","7048353","42086176870"
"258830","세종메디칼","4140","5550","1410","34.06","215740984","1418594886325"
"036630","세종텔레콤","778","789","11","1.41","8003365","6439128956"
"039310","세중","2850","2915","65","2.28","1478021","4281063300"
"075580","세진중공업","5810","7500","1690","29.09","9347531","62530040000"
"067770","세진티에스","3615","3735","120","3.32","269566","1006551940"
"053450","세코닉스","7770","8200","430","5.53","1196300","9388866410"
"027970","세하","1315","1370","55","4.18","1791961","2428700105"
"252500","세화피앤씨","1350","1390","40","2.96","2988707","4053537545"
"347000","센코","12650","14600","1950","15.42","233855","3172021200"
"308170","센트랄모텍","12900","18700","5800","44.96","17042257","294680362600"
"012600","센트럴인사이트","2490","2490","0","0.00","0","0"
"331920","셀레믹스","7120","8580","1460","20.51","3910232","38252125440"
"049180","셀루메드","4415","6140","1725","39.07","48587031","288068738710"
"299660","셀리드","20450","23600","3150","15.40","12127997","312269568150"
"268600","셀리버리","16050","17000","950","5.92","10898123","299149456850"
"108860","셀바스AI","6910","7350","440","6.37","4574096","32877621200"
"208370","셀바스헬스케어","2305","2310","5","0.22","985848","2301199595"
"258250","셀젠텍","7050","6960","-90","-1.28","26810","185043740"
"068270","셀트리온","182500","213000","30500","16.71","9568863","1849873054500"
"068760","셀트리온제약","79400","90200","10800","13.60","2642256","219718852500"
"091990","셀트리온헬스케어","71500","79300","7800","10.91","14367556","1045696522400"
"060230","소니드","3640","4150","510","14.01","12918985","50132226065"
"290690","소룩스","8810","8570","-240","-2.72","396328","3431211710"
"053110","소리바다","3960","3960","0","0.00","0","0"
"950200","소마젠","5590","6180","590","10.55","2764952","17774048080"
"032680","소프트센","1770","1870","100","5.65","29662555","58039760450"
"032685","소프트센우","26350","24350","-2000","-7.59","26574","644119300"
"258790","소프트캠프","1725","1775","50","2.90","5038166","9529880015"
"066910","손오공","2305","2225","-80","-3.47","1765739","3990985970"
"043100","솔고바이오","574","591","17","2.96","5600226","3288040632"
"336370","솔루스첨단소재","42850","46850","4000","9.33","6832028","289752255450"
"33637K","솔루스첨단소재1우","10600","11400","800","7.55","607962","6285253230"
"33637L","솔루스첨단소재2우B","13800","14500","700","5.07","425195","6243371700"
"154040","솔루에타","2825","2885","60","2.12","327230","926237390"
"248070","솔루엠","19400","21550","2150","11.08","2068565","42232208000"
"035610","솔본","3695","4185","490","13.26","6041805","26396883455"
"357780","솔브레인","229600","225600","-4000","-1.74","461949","103965652800"
"036830","솔브레인홀딩스","19550","22100","2550","13.04","448808","9108187800"
"304100","솔트룩스","9320","10050","730","7.83","652973","6511891800"
"004430","송원산업","19800","19000","-800","-4.04","8387027","160106250100"
"086980","쇼박스","4860","5090","230","4.73","53802501","292932500505"
"050960","수산아이앤티","11150","12050","900","8.07","629377","7234213700"
"017550","수산중공업","3185","3105","-80","-2.51","16461309","49458098145"
"253840","수젠텍","15850","13900","-1950","-12.30","28040255","477569386200"
"185190","수프로","1520","1395","-125","-8.22","32133","82346820"
"236200","슈프리마","21700","24050","2350","10.83","593762","13961639900"
"317770","슈프리마아이디","14550","16200","1650","11.34","2082922","34545714400"
"094840","슈프리마에이치큐","6010","6610","600","9.98","416180","2620788010"
"192440","슈피겐코리아","38050","37550","-500","-1.31","94979","3572371950"
"136510","스마트솔루션즈","11600","11600","0","0.00","0","0"
"099440","스맥","2595","2675","80","3.08","27922289","71349475155"
"053210","스카이라이프","9070","9980","910","10.03","10074925","94959738650"
"033790","스카이문스테크놀로지","829","829","0","0.00","0","0"
"131100","스카이이앤엠","2935","3230","295","10.05","452578","1393013985"
"276040","스코넥","12150","13100","950","7.82","4708204","61695839900"
"159910","스킨앤스킨","236","231","-5","-2.12","134941886","33842975205"
"115570","스타플렉스","4375","4370","-5","-0.11","631421","2725108195"
"258540","스템랩","2990","2460","-530","-17.73","91168","213929070"
"330730","스톤브릿지벤처스","5850","6130","280","4.79","9088141","58857219180"
"253450","스튜디오드래곤","73600","81800","8200","11.14","3078556","236078945800"
"204630","스튜디오산타클로스","7140","9120","1980","27.73","9970745","105059781710"
"026890","스틱인베스트먼트","7310","8230","920","12.59","13626605","111027331740"
"013810","스페코","5830","6470","640","10.98","11258067","69064089270"
"049830","승일","14850","15000","150","1.01","15053713","235309980400"
"020710","시공테크","5300","5590","290","5.47","3530832","19302038655"
"033170","시그네틱스","1635","1705","70","4.28","22556585","39155111295"
"048870","시너지이노베이션","3680","4205","525","14.27","6986630","27946254995"
"025320","시노펙스","3305","3400","95","2.87","118229669","406493172600"
"134790","시디즈","51100","48000","-3100","-6.07","1351094","72368371850"
"269620","시스웍","889","889","0","0.00","0","0"
"131090","시큐브","1055","1110","55","5.21","1444501","1549421585"
"232830","시큐센","2815","4270","1455","51.69","60173","209337665"
"139050","시티랩스","614","607","-7","-1.14","5377775","3249309586"
"016590","신대양제지","87000","86300","-700","-0.80","28813","2512783700"
"290520","신도기연","4885","5290","405","8.29","1812672","10037833245"
"029530","신도리코","31350","32100","750","2.39","231163","7317550086"
"004970","신라교역","10400","10800","400","3.85","128155","1361909550"
"001000","신라섬유","1765","2145","380","21.53","48826580","105815692425"
"025870","신라에스지","10500","11250","750","7.14","1273314","14687237200"
"215600","신라젠","12100","12100","0","0.00","0","0"
"065350","신성델타테크","10300","12000","1700","16.50","2718267","30306065010"
"011930","신성이엔지","1915","2375","460","24.02","143318643","316831252555"
"005390","신성통상","2945","3140","195","6.62","15811323","48486637055"
"004170","신세계","217500","227000","9500","4.37","1038264","226283930000"
"035510","신세계 I&C","13850","15150","1300","9.39","697966","9970387200"
"034300","신세계건설","25400","26750","1350","5.31","134909","3419890600"
"031430","신세계인터내셔날","29850","30050","200","0.67","2688921","79981232250"
"031440","신세계푸드","57800","62000","4200","7.27","123662","7388250300"
"006880","신송홀딩스","13050","10050","-3000","-22.99","11184429","124413581130"
"002800","신신제약","5250","5490","240","4.57","1320704","7351408920"
"344050","신영스팩6호","2285","2285","0","0.00","0","0"
"419270","신영스팩7호","2145","2135","-10","-0.47","316418","679073225"
"005800","신영와코루","11600","11900","300","2.59","172980","1998052000"
"001720","신영증권","55100","57000","1900","3.45","51731","2888193200"
"001725","신영증권우","57000","58200","1200","2.11","16015","916609400"
"009270","신원","1655","1795","140","8.46","15157045","25696304945"
"017000","신원종합개발","7230","7970","740","10.24","7823607","59721573120"
"002700","신일전자","2210","1910","-300","-13.57","46431316","96784945735"
"012790","신일제약","8900","9680","780","8.76","5682943","59847862170"
"138070","신진에스엠","5154","4115","-1039","-20.16","46160838","459631846650"
"226330","신테카바이오","9600","10900","1300","13.54","1516801","16077786630"
"019170","신풍제약","24600","28650","4050","16.46","34829970","1081271173150"
"019175","신풍제약우","46000","46150","150","0.33","278600","13822217550"
"002870","신풍제지","1580","1740","160","10.13","29174013","56834894780"
"404990","신한서부티엔디리츠","5020","4785","-235","-4.68","1656871","8011818560"
"293940","신한알파리츠","7790","7800","10","0.13","2154903","16740678200"
"333050","신한제6호스팩","2350","2165","-185","-7.87","24626846","65153490825"
"366330","신한제7호스팩","2135","2115","-20","-0.94","3475907","7801111905"
"393360","신한제8호스팩","2150","2150","0","0.00","248507","533953655"
"405640","신한제9호스팩","2145","2125","-20","-0.93","426955","910796690"
"055550","신한지주","36250","35950","-300","-0.83","29141279","1029038668585"
"056700","신화인터텍","4200","5100","900","21.43","193501042","1000733582930"
"187270","신화콘텍","5970","5810","-160","-2.68","10427761","63020376730"
"004080","신흥","16300","16000","-300","-1.84","35447","568911650"
"243840","신흥에스이씨","52600","58000","5400","10.27","948658","51972828100"
"257720","실리콘투","4425","2680","-1745","-39.44","44029451","218294898115"
"222800","심텍","38000","37750","-250","-0.66","18490069","741792810850"
"036710","심텍홀딩스","3840","4210","370","9.64","21986248","100057615085"
"160980","싸이맥스","13850","14500","650","4.69","546893","7996893900"
"356890","싸이버원","10800","11400","600","5.56","11783080","156424467900"
"217330","싸이토젠","58400","60100","1700","2.91","144254","8507641300"
"102280","쌍방울","545","544","-1","-0.18","101735895","55885787550"
"003410","쌍용C&E","6520","6880","360","5.52","10240828","66889201570"
"010280","쌍용정보통신","1160","1070","-90","-7.76","8371939","9102426700"
"003620","쌍용차","2770","2770","0","0.00","0","0"
"004770","써니전자","2725","2855","130","4.77","27439613","78015173245"
"217320","썬테크","6710","5310","-1400","-20.86","347","2404940"
"208640","썸에이지","1135","1180","45","3.96","21330109","26089195935"
"222420","쎄노텍","2035","2140","105","5.16","12475643","26622416925"
"037760","쎄니트","1660","1900","240","14.46","19599132","37762948010"
"099320","쎄트렉아이","32950","36200","3250","9.86","1278993","44373519400"
"015540","쎌마테라퓨틱스","6410","6410","0","0.00","0","0"
"049960","쎌바이오텍","13850","13650","-200","-1.44","214390","2964835850"
"050890","쏠리드","5040","5510","470","9.33","3860686","20447944045"
"066790","씨씨에스","549","519","-30","-5.46","3975858","2110283124"
"222080","씨아이에스","13650","15750","2100","15.38","23014427","336316432600"
"004920","씨아이테크","1270","1250","-20","-1.57","26154363","35183467820"
"236030","씨알푸드","6590","6930","340","5.16","74","480850"
"103660","씨앗","5950","5950","0","0.00","0","0"
"352480","씨앤씨인터내셔널","17400","19850","2450","14.08","592547","11813226700"
"245450","씨앤에스링크","2080","2060","-20","-0.96","14","29125"
"264660","씨앤지하이테크","11500","11800","300","2.61","480114","5860187550"
"352700","씨앤투스성진","5290","5680","390","7.37","9681628","55842985270"
"297090","씨에스베어링","9760","12550","2790","28.59","68762381","732588526910"
"112610","씨에스윈드","49150","65400","16250","33.06","7394540","406249708500"
"359090","씨엔알리서치","1780","1710","-70","-3.93","1666715","2881432190"
"286000","씨엔티드림","3210","2595","-615","-19.16","65327","168407950"
"115530","씨엔플러스","536","679","143","26.68","16100133","9955986190"
"115480","씨유메디칼","1075","1150","75","6.98","9720672","10714482168"
"376290","씨유테크","4660","5270","610","13.09","5821327","33160269950"
"189330","씨이랩","13150","13750","600","4.56","303713","4014894650"
"096530","씨젠","44700","39600","-5100","-11.41","19988471","885515909950"
"900120","씨케이에이치","252","268","16","6.35","40368026","10665820769"
"101240","씨큐브","6670","7110","440","6.60","324647","2194365010"
"060590","씨티씨바이오","8200","8830","630","7.68","1451819","12197306340"
"260930","씨티케이","7050","7850","800","11.35","729703","5418251350"
"013990","아가방컴퍼니","2960","3150","190","6.42","1705680","5194267105"
"123860","아나패스","22050","23750","1700","7.71","345929","8114126900"
"025980","아난티","6740","7670","930","13.80","9265492","64551585950"
"008700","아남전자","2350","2785","435","18.51","118281071","318392251915"
"058220","아리온","275","275","0","0.00","0","0"
"125210","아모그린텍","11100","13750","2650","23.87","6605681","81176648050"
"002790","아모레G","37800","35900","-1900","-5.03","2514297","93319010300"
"00279K","아모레G3우(전환)","31950","29550","-2400","-7.51","56206","1745638100"
"002795","아모레G우","14450","14200","-250","-1.73","156778","2247963400"
"090430","아모레퍼시픽","133000","126500","-6500","-4.89","5094688","666559864500"
"090435","아모레퍼시픽우","49800","48050","-1750","-3.51","396507","19184145347"
"357580","아모센스","12650","16200","3550","28.06","5515238","82922502150"
"052710","아모텍","21750","26400","4650","21.38","872823","21242865550"
"074430","아미노로직스","2740","2610","-130","-4.74","34291650","87019206060"
"092040","아미코젠","24300","26500","2200","9.05","1771776","43248810550"
"083930","아바코","10400","11700","1300","12.50","1285013","14095585050"
"149950","아바텍","15000","15950","950","6.33","465427","7747195350"
"036010","아비코전자","10050","12050","2000","19.90","4817126","52886967780"
"002030","아세아","114000","125000","11000","9.65","45671","5396424500"
"183190","아세아시멘트","11150","12950","1800","16.14","2977496","34578492570"
"002310","아세아제지","33700","37250","3550","10.53","392318","13859159050"
"050860","아세아텍","2850","3065","215","7.54","3389271","9967740345"
"012170","아센디오","1330","1140","-190","-14.29","5755335","6938678120"
"136410","아셈스","14000","15250","1250","8.93","5764638","87660460350"
"246720","아스타","4085","4265","180","4.41","348593","1457853615"
"067390","아스트","5090","5250","160","3.14","2034789","11322591035"
"159010","아스플로","7703","11950","4247","55.13","17706099","263123009900"
"127710","아시아경제","2075","2190","115","5.54","2680622","5983505520"
"267850","아시아나IDT","14300","14050","-250","-1.75","265344","3717579850"
"020560","아시아나항공","15250","15200","-50","-0.33","6362760","93846257200"
"154030","아시아종묘","4390","4440","50","1.14","3024411","14274784910"
"227610","아우딘퓨쳐스","1505","1770","265","17.61","5237174","8491026255"
"143160","아이디스","23450","26300","2850","12.15","243579","5985768400"
"054800","아이디스홀딩스","12700","13300","600","4.72","170284","2244987000"
"332370","아이디피","7730","8830","1100","14.23","666095","5588143420"
"122900","아이마켓코리아","10250","10350","100","0.98","751536","7662325310"
"339950","아이비김영","2135","2455","320","14.99","40058518","107660285615"
"099190","아이센스","32750","37700","4950","15.11","1970733","69037496050"
"289010","아이스크림에듀","4445","5180","735","16.54","21554757","120892340175"
"214430","아이쓰리시스템","17050","19150","2100","12.32","497434","9221226550"
"040910","아이씨디","9200","9620","420","4.57","322719","3001140620"
"068940","아이씨케이","3865","4180","315","8.15","18734597","73449286925"
"052860","아이앤씨","2950","3005","55","1.86","604419","1771465600"
"010780","아이에스동서","40800","41650","850","2.08","1330404","53320803350"
"069920","아이에스이커머스","8160","7980","-180","-2.21","8932496","73855684120"
"038880","아이에이","803","818","15","1.87","24148219","19590471644"
"307180","아이엘사이언스","4035","4025","-10","-0.25","2534394","9750007445"
"101390","아이엠","4780","5290","510","10.67","876590","4524303995"
"078860","아이오케이","721","742","21","2.91","17204747","13260212841"
"114810","아이원스","7310","7990","680","9.30","1676146","12973228240"
"090150","아이윈","1810","2330","520","28.73","40998900","91682815620"
"123010","아이윈플러스","720","692","-28","-3.89","46273854","29823588189"
"031310","아이즈비전","2900","3035","135","4.66","1480362","4469985640"
"185490","아이진","9650","10700","1050","10.88","7199738","76738137790"
"059100","아이컴포넌트","6510","6680","170","2.61","359658","2396705850"
"149010","아이케이세미콘","7970","7400","-570","-7.15","21310","160384420"
"262840","아이퀘스트","8880","9400","520","5.86","10779654","102336640810"
"175250","아이큐어","13300","12950","-350","-2.63","3756777","52456512800"
"052460","아이크래프트","3550","3740","190","5.35","5066449","20101407270"
"119830","아이텍","9380","8410","-970","-10.34","6976128","64213577830"
"052770","아이톡시","2085","2085","0","0.00","0","0"
"124500","아이티센","4155","4310","155","3.73","1436086","5950424285"
"372800","아이티아이즈","12600","12500","-100","-0.79","7554026","89163026920"
"084850","아이티엠반도체","32050","35150","3100","9.67","420790","13950958200"
"114840","아이패밀리에스씨","12200","12850","650","5.33","1576245","19409752400"
"027360","아주IB투자","2965","3200","235","7.93","63638781","214148467135"
"139990","아주스틸","10400","11600","1200","11.54","1611184","18442418550"
"032080","아즈텍WB","2200","2545","345","15.68","28145042","73566345500"
"013310","아진산업","2705","3010","305","11.28","10029087","29185621800"
"059120","아진엑스텍","9550","11050","1500","15.71","4474660","47859860920"
"158430","아톤","28750","29900","1150","4.00","842081","24907912300"
"149300","아퓨어스","1680","1680","0","0.00","17398","28304145"
"067160","아프리카TV","83400","85000","1600","1.92","4647140","399747699500"
"001540","안국약품","8370","9320","950","11.35","4799415","47866281520"
"053800","안랩","88900","92600","3700","4.16","3356615","303164773800"
"251280","안지오랩","9970","9400","-570","-5.72","27220","244812320"
"065660","안트로젠","21400","22400","1000","4.67","1107371","24432304550"
"297570","알로이스","1635","2115","480","29.36","102305244","222184060900"
"001780","알루코","2950","3200","250","8.47","12630373","38786033080"
"260660","알리코제약","6240","6810","570","9.13","2049697","14019397240"
"361570","알비더블유","17950","18150","200","1.11","10320559","204359967700"
"131370","알서포트","4720","5170","450","9.53","23498783","127695897790"
"140670","알에스오토메이션","13350","15600","2250","16.85","8165576","128795391800"
"096610","알에프세미","3080","4175","1095","35.55","17165107","71529735525"
"061040","알에프텍","5280","5690","410","7.77","3738938","20465330350"
"148250","알엔투테크놀로지","8330","8110","-220","-2.64","1789535","15095579370"
"347860","알체라","13700","16050","2350","17.15","1468146","22022209350"
"196170","알테오젠","63900","74100","10200","15.96","8622007","588332220600"
"123750","알톤스포츠","3205","3610","405","12.64","8609293","31131001510"
"085810","알티캐스트","1600","1745","145","9.06","3864102","6600575205"
"117670","알파홀딩스","2490","2325","-165","-6.63","4895641","11790063630"
"291650","압타머사이언스","13200","10650","-2550","-19.32","11846638","150176350700"
"293780","압타바이오","17050","19000","1950","11.44","31699463","712360927000"
"267810","앙츠","1335","1490","155","11.61","3780","5509095"
"018250","애경산업","14450","14150","-300","-2.08","411154","5961518800"
"161000","애경케미칼","8260","8580","320","3.87","1618454","13205369940"
"196300","애니젠","9470","9440","-30","-0.32","214158","1980729710"
"310200","애니플러스","2860","3200","340","11.89","7883988","25138214640"
"179530","애드바이오텍","4780","5110","330","6.90","2001430","9793489280"
"900100","애머릿지","3585","3585","0","0.00","0","0"
"205500","액션스퀘어","2700","3350","650","24.07","14662860","47574176645"
"052790","액토즈소프트","9040","9900","860","9.51","523035","4948757780"
"290740","액트로","7230","7370","140","1.94","992281","7184153690"
"238090","앤디포스","6800","7290","490","7.21","5332000","40009737330"
"092600","앤씨앤","2905","2415","-490","-16.87","4981444","12539453745"
"129890","앱코","11450","11450","0","0.00","1025251","11653691350"
"174900","앱클론","11450","12750","1300","11.35","3198883","41079395350"
"255440","야스","9170","9400","230","2.51","239212","2285384000"
"030960","양지사","7420","16400","8980","121.02","20399167","275391566090"
"102120","어보브반도체","9950","10800","850","8.54","1765184","18216844410"
"263540","어스앤에어로스페이스","10900","10900","0","0.00","0","0"
"238120","얼라인드","9860","10150","290","2.94","555636","5547923910"
"224810","엄지하우스","6470","4775","-1695","-26.20","4618","20594555"
"019990","에너토크","10700","12050","1350","12.62","3500956","38226470580"
"011090","에넥스","1370","1600","230","16.79","16725767","25614318650"
"270660","에브리봇","29500","35700","6200","21.02","7884249","289485502500"
"038680","에스넷","5560","6140","580","10.43","5026589","32389714300"
"137310","에스디바이오센서","43900","39300","-4600","-10.48","15568862","700293645700"
"217480","에스디생명공학","1960","2910","950","48.47","14380747","39405587310"
"121890","에스디시스템","739","739","0","0.00","0","0"
"097780","에스맥","3385","3385","0","0.00","0","0"
"042110","에스씨디","2250","1870","-380","-16.89","19600628","40296383365"
"298060","에스씨엠생명과학","10950","11250","300","2.74","1119152","12865766700"
"065420","에스아이리소스","699","783","84","12.02","52821737","41523329110"
"270210","에스알바이오텍","4205","3870","-335","-7.97","2734","10414390"
"103230","에스앤더블류","2505","2505","0","0.00","0","0"
"260970","에스앤디","19050","20100","1050","5.51","281507","5368277050"
"101490","에스앤에스텍","19650","20100","450","2.29","1970517","39647888950"
"095910","에스에너지","4335","5390","1055","24.34","55071519","269692702555"
"275630","에스에스알","4780","5530","750","15.69","392627","2060516815"
"031330","에스에이엠티","3540","3675","135","3.81","2770077","10067578175"
"060540","에스에이티","2715","2700","-15","-0.55","3009957","8098005850"
"351320","에스에이티이엔지","3570","3620","50","1.40","2098820","7652815020"
"056190","에스에프에이","39850","42200","2350","5.90","2567387","106673822350"
"080000","에스엔유","2895","3020","125","4.32","1016147","3041870485"
"086460","에스엔피제네틱스","10000","7900","-2100","-21.00","13753","106122180"
"005850","에스엘","28900","31000","2100","7.27","4065942","127121082200"
"214310","에스엘바이오닉스","3490","5850","2360","67.62","3664369","17570708620"
"246250","에스엘에스바이오","7100","7000","-100","-1.41","62051","453303300"
"041510","에스엠","68500","74600","6100","8.91","8095115","573365204600"
"010580","에스엠벡셀","1530","1530","0","0.00","0","0"
"299670","에스엠비나","3000","2785","-215","-7.17","155","441675"
"007820","에스엠코어","6140","7030","890","14.50","5805267","39261323230"
"109610","에스와이","3775","3685","-90","-2.38","32420995","118156397750"
"012750","에스원","63700","62500","-1200","-1.88","929402","58639195550"
"306040","에스제이그룹","21050","22100","1050","4.99","456767","9738867200"
"217910","에스제이켐","310","304","-6","-1.94","42669","12956073"
"224020","에스케이씨에스","3740","4340","600","16.04","13938","54222170"
"408920","에스케이증권7호스팩","2185","2185","0","0.00","0","0"
"096630","에스코넥","1170","1235","65","5.56","1786757","2111637430"
"069510","에스텍","6650","7510","860","12.93","376610","2748993900"
"041910","에스텍파마","7720","8850","1130","14.64","3349639","29938894180"
"234300","에스트래픽","3880","4110","230","5.93","2257958","9708550695"
"039440","에스티아이","15750","15250","-500","-3.17","3322099","53687095850"
"098660","에스티오","2370","2295","-75","-3.16","908059","2034831845"
"052020","에스티큐브","7160","19350","12190","170.25","34450097","466200578020"
"237690","에스티팜","95100","116800","21700","22.82","2882570","294922695200"
"050760","에스폴리텍","3395","3650","255","7.51","6403268","23789714595"
"288620","에스퓨얼셀","22100","24400","2300","10.41","1604811","36413566600"
"317830","에스피시스템스","10100","10550","450","4.46","8932961","91742003242"
"058610","에스피지","12850","17250","4400","34.24","18292626","275131777600"
"043340","에쎈테크","1240","1010","-230","-18.55","8696424","9563349690"
"023960","에쓰씨엔지니어링","2365","2285","-80","-3.38","6227812","14152915995"
"298690","에어부산","3859","3580","-279","-7.23","4807736","7936789750"
"187660","에이디엠코리아","3150","3115","-35","-1.11","3833771","12316819185"
"054630","에이디칩스","291","350","59","20.27","98820139","38699623389"
"200710","에이디테크놀로지","13300","14100","800","6.02","852034","11738725650"
"096690","에이루트","428","522","94","21.96","177352242","96214443635"
"140910","에이리츠","5570","5650","80","1.44","110175","595900560"
"078520","에이블씨엔씨","5260","5220","-40","-0.76","909727","4799970700"
"298380","에이비엘바이오","25500","25600","100","0.39","12246696","294016245200"
"203400","에이비온","8150","10550","2400","29.45","2840770","27925572320"
"195990","에이비프로바이오","854","844","-10","-1.17","34621428","30163308581"
"003800","에이스침대","40950","43000","2050","5.01","11964","503770150"
"088800","에이스테크","7240","7920","680","9.39","4118450","31161816230"
"241840","에이스토리","27750","26700","-1050","-3.78","17703964","548401688200"
"312610","에이에프더블류","3345","3750","405","12.11","4070692","15870921015"
"015260","에이엔피","2445","2325","-120","-4.91","4435843","10191153205"
"234070","에이원알폼","24850","24850","0","0.00","0","0"
"072990","에이치시티","11000","10650","-350","-3.18","508613","5600247300"
"227100","에이치앤비디자인","7090","4780","-2310","-32.58","4566578","26226040910"
"044990","에이치엔에스하이텍","12150","12150","0","0.00","0","0"
"239610","에이치엘사이언스","35450","30800","-4650","-13.12","61912","1989595400"
"353070","에이치엠씨제4호스팩","2115","2105","-10","-0.47","175485","371467015"
"353060","에이치엠씨제5호스팩","2120","2100","-20","-0.94","187274","393929330"
"044780","에이치케이","1830","1900","70","3.83","1746392","3156402670"
"357230","에이치피오","9610","11900","2290","23.83","4354829","53017709690"
"071670","에이테크솔루션","12600","13250","650","5.16","1403985","17770350500"
"045660","에이텍","12550","12900","350","2.79","4764410","60563523700"
"224110","에이텍티앤","13200","12250","-950","-7.20","1759417","22888105300"
"230980","에이트원","849","1010","161","18.96","32560990","34157089252"
"021080","에이티넘인베스트","3190","3490","300","9.40","18068105","63222376790"
"089530","에이티세미콘","1130","1085","-45","-3.98","18095542","20165095917"
"200470","에이팩트","4000","5040","1040","26.00","23818030","132966023030"
"207490","에이펙스인텍","7450","8010","560","7.52","2490","19985140"
"262260","에이프로","11150","13350","2200","19.73","3107890","41218112850"
"007460","에이프로젠","1595","1500","-95","-5.96","60982141","94322918960"
"109960","에이프로젠 H&G","518","535","17","3.28","2972304","1582925044"
"003060","에이프로젠제약","595","676","81","13.61","18502543","12108398086"
"244920","에이플러스에셋","6030","6330","300","4.98","1877540","11749552590"
"089970","에이피티씨","16050","17200","1150","7.17","3313283","54432590600"
"230240","에치에프알","27650","33600","5950","21.52","1904276","58402979750"
"230360","에코마케팅","14800","18050","3250","21.96","5497238","94863203900"
"038870","에코바이오","6720","6860","140","2.08","943228","6327906700"
"128540","에코캡","6230","8000","1770","28.41","56972655","435533807580"
"086520","에코프로","71400","119600","48200","67.51","26590711","2558411583300"
"247540","에코프로비엠","118900","122700","3800","3.20","26359746","3141333934600"
"383310","에코프로에이치엔","37750","61000","23250","61.59","7638338","409958695200"
"038110","에코플라스틱","2735","3005","270","9.87","49365073","147303766910"
"073540","에프알텍","3070","3120","50","1.63","718742","2205139075"
"064850","에프앤가이드","6410","7960","1550","24.18","5222266","40619083160"
"064090","에프앤리퍼블릭","2585","2790","205","7.93","393637","1050913970"
"036810","에프에스티","14650","15250","600","4.10","949507","14156331700"
"173940","에프엔씨엔터","5900","5630","-270","-4.58","388440","2261554850"
"083500","에프엔에스테크","8010","9320","1310","16.35","738116","6352540350"
"054940","엑사이엔씨","1140","1195","55","4.82","2545647","2903992645"
"950130","엑세스바이오","17200","17550","350","2.03","50415036","998985037350"
"205100","엑셈","3785","4180","395","10.44","6561239","26548958115"
"070300","엑스큐어","2555","3115","560","21.92","389002","1151127135"
"092870","엑시콘","9280","9800","520","5.60","847031","8260972990"
"317870","엔바이오니아","11200","8550","-2650","-23.66","786917","7280016950"
"067570","엔브이에이치코리아","3465","3765","300","8.66","1448819","5221991495"
"236810","엔비티","7390","7160","-230","-3.11","3456612","26158670400"
"140610","엔솔바이오사이언스","14000","12950","-1050","-7.50","140814","1882300850"
"333620","엔시스","13500","14950","1450","10.74","472908","6660329950"
"101400","엔시트론","781","794","13","1.66","6020903","4748483766"
"036570","엔씨소프트","373500","402000","28500","7.63","2168302","821044485750"
"217820","엔에스","8360","8800","440","5.26","1614185","14591305220"
"031860","엔에스엔","1200","1280","80","6.67","21936653","26602109590"
"238170","엔에스엠","766","849","83","10.84","39266","27347927"
"224760","엔에스컴퍼니","3295","2450","-845","-25.64","6092","15962555"
"380440","엔에이치스팩19호","2100","2085","-15","-0.71","1529801","3202983495"
"391060","엔에이치스팩20호","2100","2085","-15","-0.71","643239","1346590520"
"396770","엔에이치스팩22호","2150","2130","-20","-0.93","237004","509784710"
"422040","엔에이치스팩23호","2115","2115","0","0.00","465052","987889920"
"265740","엔에프씨","11250","10900","-350","-3.11","443725","4946842300"
"354200","엔젠바이오","8180","8780","600","7.33","2156000","22138730790"
"093510","엔지브이아이","2000","2000","0","0.00","100","198875"
"208860","엔지스테크널러지","2205","2205","0","0.00","0","0"
"183490","엔지켐생명과학","17000","21050","4050","23.82","11573617","266973947900"
"085310","엔케이","873","1000","127","14.55","1894591","1727968424"
"182400","엔케이맥스","15300","16900","1600","10.46","10585738","174665166700"
"348370","엔켐","47100","57200","10100","21.44","2708545","136935233850"
"069410","엔텔스","5640","6090","450","7.98","889238","5369769620"
"227950","엔투텍","1385","1330","-55","-3.97","8268852","11593277520"
"291230","엔피","7210","7750","540","7.49","13394810","107294607590"
"198080","엔피디","2380","2545","165","6.93","372545","923012550"
"048830","엔피케이","2020","2245","225","11.14","3287326","7105917295"
"096870","엘디티","3685","3695","10","0.27","399386","1475196695"
"276240","엘리비젼","598","749","151","25.25","16375","9387793"
"900140","엘브이엠씨홀딩스","2920","3065","145","4.97","3110795","9141312850"
"376190","엘비루셈","7310","7800","490","6.70","361568","2766198580"
"061970","엘비세미콘","8310","9360","1050","12.64","7975951","72373119760"
"138690","엘아이에스","982","982","0","0.00","0","0"
"290650","엘앤씨바이오","31700","28550","-3150","-9.94","2857315","86514991300"
"066970","엘앤에프","214200","245000","30800","14.38","9940594","2250861792000"
"156100","엘앤케이바이오","10350","11500","1150","11.11","1071786","12622785000"
"311060","엘에이티","3800","4700","900","23.68","10301","41385045"
"073110","엘엠에스","7960","8070","110","1.38","297226","2373691580"
"083310","엘오티베큠","12450","11600","-850","-6.83","2263011","27971545600"
"037950","엘컴텍","1150","1180","30","2.61","7116102","8290489200"
"170920","엘티씨","8130","8890","760","9.35","301373","2496613340"
"058630","엠게임","7590","8250","660","8.70","6602786","52739292740"
"058970","엠로","16500","15300","-1200","-7.27","739640","11987409400"
"019590","엠벤처투자","1205","1475","270","22.41","16332386","23322131625"
"169330","엠브레인","3545","3585","40","1.13","552229","1953000175"
"097520","엠씨넥스","31050","34650","3600","11.59","1131050","36879485750"
"179290","엠아이텍","9170","12300","3130","34.13","11894332","125976239830"
"009780","엠에스씨","5790","6070","280","4.84","141424","843795460"
"123040","엠에스오토텍","4295","4930","635","14.78","2602774","12483685025"
"323230","엠에프엠코리아","889","944","55","6.19","1031990","948168666"
"033160","엠케이전자","11000","13300","2300","20.91","3748960","44973971400"
"347890","엠투아이","8250","9460","1210","14.67","2602551","23538442060"
"033310","엠투엔","6400","8640","2240","35.00","17748008","147287413760"
"259630","엠플러스","14750","16600","1850","12.54","2250086","36288748150"
"065150","엠피대산","569","562","-7","-1.23","2589459","1463385256"
"115960","연우","17250","18050","800","4.64","496060","8601872950"
"090740","연이비앤티","2105","2105","0","0.00","0","0"
"060850","영림원소프트랩","8630","10550","1920","22.25","3533899","36050448520"
"014440","영보화학","3625","4235","610","16.83","5138569","21224034560"
"007530","영신금속","2705","2675","-30","-1.11","442477","1186013705"
"143540","영우디에스피","1530","1920","390","25.49","110628185","220329107395"
"111770","영원무역","39650","42000","2350","5.93","1978534","79432326678"
"009970","영원무역홀딩스","47300","47100","-200","-0.42","383438","18286874050"
"003520","영진약품","3555","3610","55","1.55","7205852","26039094320"
"000670","영풍","511000","592000","81000","15.85","19952","10722936500"
"036560","영풍정밀","8560","9210","650","7.59","1802743","17089376080"
"006740","영풍제지","7280","7280","0","0.00","5141381","38215572890"
"012280","영화금속","1100","1200","100","9.09","4218147","4873111530"
"265560","영화테크","12700","13950","1250","9.84","2874694","38497741400"
"012160","영흥","785","847","62","7.90","2665936","2194194440"
"036000","예림당","1900","1995","95","5.00","379118","726104555"
"250930","예선테크","1325","1455","130","9.81","5902029","8744811375"
"053280","예스24","6370","6750","380","5.97","1263323","8376255040"
"015360","예스코홀딩스","34600","35150","550","1.59","57138","2010693750"
"122640","예스티","6760","9100","2340","34.62","1928974","15540365710"
"900300","오가닉티코스메틱","348","332","-16","-4.60","22893371","7712135407"
"045060","오공","3655","3825","170","4.65","6277396","25533137760"
"080520","오디텍","5480","5650","170","3.10","1192504","6559088350"
"007310","오뚜기","433500","466500","33000","7.61","275960","124132977000"
"039830","오로라","7940","8750","810","10.20","486724","4055900530"
"322310","오로스테크놀로지","15150","14850","-300","-1.98","384520","5643577950"
"046120","오르비텍","6970","7390","420","6.03","69265194","490897549470"
"014940","오리엔탈정공","2805","3370","565","20.14","8323110","27618064435"
"002630","오리엔트바이오","760","836","76","10.00","8958381","7368832433"
"065500","오리엔트정공","1595","1900","305","19.12","2900719","5065056730"
"271560","오리온","106000","105000","-1000","-0.94","2957808","305506524000"
"001800","오리온홀딩스","14950","15000","50","0.33","1412309","21162426200"
"010470","오리콤","6850","6500","-350","-5.11","2180870","14077426810"
"352910","오비고","10950","11500","550","5.02","2732694","31464578350"
"053980","오상자이엘","6080","6590","510","8.39","22008315","165074695820"
"052420","오성첨단소재","2150","2150","0","0.00","0","0"
"241790","오션브릿지","11000","12500","1500","13.64","724615","8906279200"
"329020","오션스톤","1485","1300","-185","-12.46","19095","26965735"
"039200","오스코텍","28150","28050","-100","-0.36","3046527","86908581750"
"226400","오스테오닉","3025","2915","-110","-3.64","759617","2271424330"
"031510","오스템","1805","2010","205","11.36","16548150","35333737290"
"048260","오스템임플란트","99300","110400","11100","11.18","3801461","395796643850"
"138080","오이솔루션","22150","23800","1650","7.45","436903","10122306600"
"080580","오킨스전자","21450","20150","-1300","-6.06","1507624","30509511300"
"067170","오텍","7660","7480","-180","-2.35","1255988","9803622970"
"353590","오토앤","11550","13650","2100","18.18","10107673","132486169950"
"173130","오파스넷","6140","5490","-650","-10.59","9234352","51264777190"
"049480","오픈베이스","2825","3080","255","9.03","16904316","51791998885"
"309930","오하임아이엔티","3120","3595","475","15.22","8968286","31599394960"
"244460","올리패스","5800","5780","-20","-0.34","4714539","27016803580"
"226950","올릭스","23500","23050","-450","-1.91","2296535","52903372700"
"057540","옴니시스템","2635","2240","-395","-14.99","54486377","139192749885"
"131030","옵투스제약","6160","6640","480","7.79","939151","6413282690"
"082210","옵트론텍","5340","5640","300","5.62","5947879","33172313370"
"109080","옵티시스","11800","14050","2250","19.07","2187948","31479687350"
"153710","옵티팜","8620","10050","1430","16.59","6069920","60812677280"
"321820","와이더플래닛","7500","7900","400","5.33","319575","2473616370"
"122990","와이솔","8590","8980","390","4.54","856310","7477871030"
"232140","와이아이케이","4140","4290","150","3.62","1445770","6036911600"
"065530","와이어블","2680","2945","265","9.89","15245915","46243227725"
"067900","와이엔텍","9220","10000","780","8.46","2793364","28463921450"
"155650","와이엠씨","6210","6020","-190","-3.06","709564","4390889140"
"273640","와이엠텍","15000","16850","1850","12.33","651827","10330195800"
"251370","와이엠티","12600","15150","2550","20.24","3473791","50962547200"
"066430","와이오엠","2005","1885","-120","-5.99","1085224","2140945775"
"193250","와이제이엠게임즈","2100","2155","55","2.62","17442189","37872131115"
"273060","와이즈버즈","1290","1295","5","0.39","1715584","2255774130"
"019210","와이지-원","6650","7440","790","11.88","2277533","15615297140"
"122870","와이지엔터테인먼트","49650","58900","9250","18.63","4695795","257392848050"
"011690","와이투솔루션","800","717","-83","-10.38","24481622","17059065710"
"332570","와이팜","4660","4760","100","2.15","1359820","6480648670"
"079000","와토스코리아","5630","6570","940","16.70","4774781","31774702440"
"070960","용평리조트","4005","4045","40","1.00","1195660","4737801325"
"316140","우리금융지주","11600","12200","600","5.17","52153688","613192798664"
"032820","우리기술","2225","2100","-125","-5.62","62771690","131194815155"
"041190","우리기술투자","5530","6320","790","14.29","69451374","435484471700"
"115440","우리넷","8730","9000","270","3.09","1595710","14118044660"
"046970","우리로","1485","1605","120","8.08","9336762","14536243605"
"082850","우리바이오","3175","3785","610","19.21","86344255","350131509990"
"215360","우리산업","14700","16300","1600","10.88","4535857","73075353250"
"072470","우리산업홀딩스","4450","5580","1130","25.39","46784234","256723195160"
"073560","우리손에프앤지","1965","1985","20","1.02","16287025","31538651250"
"037400","우리엔터프라이즈","2310","2630","320","13.85","11497582","30173921480"
"153490","우리이앤엘","1195","1355","160","13.39","6835906","9002658320"
"010050","우리종금","884","972","88","9.95","56630555","52336196064"
"101170","우림피티에스","8950","9120","170","1.90","47660059","430929792890"
"006980","우성","24900","25150","250","1.00","177053","4331730100"
"066590","우수AMS","3810","4000","190","4.99","7059585","28445153020"
"017370","우신시스템","2470","2670","200","8.10","2398635","6289095895"
"103840","우양","3800","4010","210","5.53","1600485","6420197365"
"046940","우원개발","4305","5460","1155","26.83","18275103","90143917745"
"215380","우정바이오","4970","5050","80","1.61","2960698","15548712865"
"065680","우주일렉트로","21400","21500","100","0.47","894156","18824228900"
"105840","우진","11900","13700","1800","15.13","29932182","374828203200"
"018620","우진비앤지","2115","2180","65","3.07","20183439","42873773465"
"010400","우진아이엔에스","6020","6620","600","9.97","787004","5366507200"
"049800","우진플라임","3385","3890","505","14.92","701149","2538617265"
"016880","웅진","1395","1495","100","7.17","9740860","14426179510"
"095720","웅진씽크빅","2380","2595","215","9.03","4490539","11494003950"
"005820","원림","22800","25300","2500","10.96","94738","2409056900"
"307280","원바이오젠","1625","1640","15","0.92","1144987","1866417710"
"053080","원방테크","10550","12050","1500","14.22","1862822","21357731300"
"032940","원익","3675","3835","160","4.35","350030","1319829285"
"240810","원익IPS","28700","29250","550","1.92","8106294","243151908860"
"074600","원익QnC","26600","24800","-1800","-6.77","9806530","243942001000"
"104830","원익머트리얼즈","30850","31700","850","2.76","1892708","57879063950"
"014190","원익큐브","2460","2755","295","11.99","8713287","23658273720"
"131390","원익피앤이","20650","21000","350","1.69","2301326","48207075550"
"030530","원익홀딩스","3835","3990","155","4.04","3148344","12264916660"
"012620","원일특강","11500","12100","600","5.22","3638139","44495012600"
"382840","원준","41368","35450","-5918","-14.31","9276165","379072390650"
"336570","원텍","3025","2975","-50","-1.65","23734337","72704169215"
"376980","원티드랩","21900","23250","1350","6.16","2694057","64198044950"
"122830","원포유","1890","1900","10","0.53","314392","589934730"
"008370","원풍","4880","5010","130","2.66","346610","1717656805"
"008290","원풍물산","736","854","118","16.03","7829621","6898205140"
"101160","월덱스","18550","18950","400","2.16","2672584","50822997750"
"336060","웨이버스","1720","1750","30","1.74","6664154","11604889895"
"095270","웨이브일렉트로","5580","5430","-150","-2.69","863910","4672425800"
"010600","웰바이오텍","1650","1720","70","4.24","43955502","78781819735"
"065950","웰크론","3355","3580","225","6.71","10711291","39480381135"
"076080","웰크론한텍","2935","4395","1460","49.74","100670719","424834134910"
"196700","웹스","3440","3975","535","15.55","46213075","180008012340"
"069080","웹젠","18700","20800","2100","11.23","1425644","27904309350"
"053580","웹케시","16450","20450","4000","24.32","1087261","20248930050"
"071460","위니아","2790","2545","-245","-8.78","1821082","4683770155"
"377460","위니아에이드","11700","9160","-2540","-21.71","7371256","73967649660"
"044340","위닉스","12150","12950","800","6.58","641096","7874240950"
"330350","위더스제약","8530","9000","470","5.51","606061","5443498230"
"348350","위드텍","15300","15100","-200","-1.31","210404","3184970750"
"112040","위메이드","59100","71000","11900","20.14","21828621","1468828022900"
"101730","위메이드맥스","18150","22700","4550","25.07","23218271","489561754300"
"123420","위메이드플레이","23550","28300","4750","20.17","4580514","121970285600"
"065370","위세아이텍","11350","11200","-150","-1.32","401289","4577389650"
"140660","위월드","2400","2495","95","3.96","10413","24403000"
"038620","위즈코프","1130","1200","70","6.19","25625397","30750612205"
"299900","위지윅스튜디오","21750","25550","3800","17.47","9380433","221471134150"
"036090","위지트","839","1020","181","21.57","129197752","137021892082"
"136540","윈스","13600","14300","700","5.15","412330","5725018400"
"320000","윈텍","2125","2315","190","8.94","6339444","15191547760"
"097800","윈팩","1400","1460","60","4.29","1394817","1986324865"
"192390","윈하이텍","3615","4020","405","11.20","2081348","8026144835"
"313760","윌링스","11100","11650","550","4.95","1570290","17950200650"
"008600","윌비스","931","999","68","7.30","7984823","7779992333"
"900340","윙입푸드","1365","1200","-165","-12.09","24657024","31683600915"
"033270","유나이티드제약","23550","25650","2100","8.92","1548469","39954951150"
"064510","유네코","2750","2750","0","0.00","0","0"
"014830","유니드","89000","96100","7100","7.98","1541921","146360476900"
"036200","유니셈","7360","7340","-20","-0.27","13655459","103213848410"
"018000","유니슨","2370","2775","405","17.09","22880986","58428072410"
"000910","유니온","5790","6440","650","11.23","25610850","165908855930"
"047400","유니온머티리얼","2230","3465","1235","55.38","273895059","906459042800"
"203450","유니온커뮤니티","2795","3260","465","16.64","4471399","14882730385"
"011330","유니켐","1200","1190","-10","-0.83","1867275","2215908095"
"077500","유니퀘스트","9000","9200","200","2.22","1760497","16342690600"
"011320","유니크","6520","7080","560","8.59","13479805","90577251980"
"086390","유니테스트","17850","19200","1350","7.56","3582114","65765225800"
"241690","유니테크노","5650","5820","170","3.01","2874403","16448482850"
"142210","유니트론텍","3695","4010","315","8.53","1596688","6108904185"
"121060","유니포인트","1700","1745","45","2.65","54690","95889485"
"048430","유라테크","6900","7360","460","6.67","437640","3185433060"
"206650","유바이오로직스","15750","17150","1400","8.89","9747211","164659666050"
"089850","유비벨록스","14650","16300","1650","11.26","2073549","33052044750"
"084440","유비온","2235","2295","60","2.68","135739","306649820"
"032620","유비케어","5360","6110","750","13.99","9940245","61647132670"
"264450","유비쿼스","14850","17400","2550","17.17","471273","7603047550"
"078070","유비쿼스홀딩스","16600","16150","-450","-2.71","1052485","17488859850"
"002920","유성기업","2820","2970","150","5.32","279803","808080225"
"024800","유성티엔에스","2555","2705","150","5.87","869173","2234716455"
"000700","유수홀딩스","5920","6130","210","3.55","391334","2348273420"
"054930","유신","27250","27400","150","0.55","4312327","115143983100"
"069330","유아이디","2060","2220","160","7.77","2079012","4576446490"
"049520","유아이엘","2550","3070","520","20.39","521051","1484321270"
"367460","유안타제7호스팩","2480","2180","-300","-12.10","8867780","21308453095"
"367480","유안타제8호스팩","2150","2150","0","0.00","493678","1064511235"
"003470","유안타증권","2675","2945","270","10.09","2348182","6487576145"
"003475","유안타증권우","2880","3235","355","12.33","90598","271998880"
"263770","유에스티","3025","3300","275","9.09","391302","1222170275"
"337840","유엑스엔","17400","19600","2200","12.64","58370","1060326850"
"072130","유엔젤","3180","3415","235","7.39","963006","3217373930"
"000220","유유제약","6470","6770","300","4.64","4751511","32809367590"
"000225","유유제약1우","8700","9420","720","8.28","1328868","12891174990"
"000227","유유제약2우B","17000","17250","250","1.47","22410","398754350"
"388720","유일로보틱스","21100","28550","7450","35.31","53298212","1438621350000"
"340930","유일에너테크","13250","15450","2200","16.60","1898557","28639683000"
"023410","유진기업","3905","4105","200","5.12","4122556","16153662615"
"056080","유진로봇","5020","5370","350","6.97","9050392","48039022055"
"373340","유진스팩6호","2265","2250","-15","-0.66","832091","1951605220"
"388800","유진스팩7호","2180","2155","-25","-1.15","189087","409599230"
"413630","유진스팩8호","2115","2120","5","0.24","199534","422941580"
"084370","유진테크","29650","28700","-950","-3.20","2652994","79357649088"
"001200","유진투자증권","2640","2930","290","10.98","3037364","8538514940"
"178780","유테크","1730","1730","0","0.00","0","0"
"221800","유투바이오","28750","29000","250","0.87","1698","43481400"
"179900","유티아이","17500","22900","5400","30.86","3375381","77187029200"
"263050","유틸렉스","6700","5270","-1430","-21.34","33059068","179760629040"
"000100","유한양행","57300","59100","1800","3.14","3084589","177764313800"
"000105","유한양행우","55200","56800","1600","2.90","9963","559188800"
"003460","유화증권","2340","2500","160","6.84","232688","552739530"
"003465","유화증권우","2535","2590","55","2.17","10556","27511205"
"191410","육일씨엔에쓰","3180","3455","275","8.65","717769","2459211875"
"008730","율촌화학","19000","26150","7150","37.63","2370033","50495083400"
"072770","율호","1385","1620","235","16.97","8943217","13368613395"
"008250","이건산업","8690","9500","810","9.32","978939","8655718910"
"039020","이건홀딩스","3910","3960","50","1.28","3843258","14634371460"
"025820","이구산업","2985","3320","335","11.22","4207269","13022649675"
"067920","이글루","5320","5690","370","6.95","1369075","7962439340"
"044960","이글벳","6200","6730","530","8.55","11527476","76799240560"
"303530","이노뎁","14600","14100","-500","-3.42","980561","14646260650"
"302430","이노메트리","9550","12000","2450","25.65","400948","4385660150"
"279060","이노벡스","4665","4865","200","4.29","65289","309515060"
"214320","이노션","45850","43350","-2500","-5.45","2667976","120394985900"
"056090","이노시스","2220","4550","2330","104.95","62820740","666221493130"
"073490","이노와이어리스","28000","29650","1650","5.89","861750","25131860400"
"215790","이노인스트루먼트","1665","1705","40","2.40","1648393","2741294345"
"344860","이노진","7000","7390","390","5.57","7996","56083140"
"246960","이노테라피","9150","9510","360","3.93","56685","528788850"
"088390","이녹스","21200","25100","3900","18.40","1774150","42902982600"
"272290","이녹스첨단소재","34050","33500","-550","-1.62","6877884","236857183950"
"053350","이니텍","3930","4195","265","6.74","2449663","10658179515"
"041520","이라이콤","5410","5810","400","7.39","481904","2670235730"
"264850","이랜시스","2925","3265","340","11.62","14980849","51136950495"
"054210","이랜텍","18950","19400","450","2.37","8836605","171694267050"
"164060","이루다","5320","5810","490","9.21","6002136","33679295295"
"065440","이루온","2410","3225","815","33.82","233157190","692835650575"
"088260","이리츠코크렙","5780","5820","40","0.69","1268729","7106740330"
"139480","이마트","106500","108500","2000","1.88","4563085","493291768350"
"115610","이미지스","2565","2615","50","1.95","2081593","5420517075"
"349720","이베스트스팩5호","2100","2105","5","0.24","115647","242657010"
"078020","이베스트투자증권","6470","6810","340","5.26","1129183","7422810880"
"131400","이브이첨단소재","1895","1800","-95","-5.01","40268223","76538438085"
"208850","이비테크","6060","5990","-70","-1.16","3226","17878630"
"351330","이삭엔지니어링","11100","11650","550","4.95","1050801","12185037750"
"080010","이상네트웍스","5490","5770","280","5.10","1194472","6629807310"
"379390","이성씨엔아이","12050","11800","-250","-2.07","328","3350550"
"086890","이수앱지스","8190","8260","70","0.85","14463889","124797835650"
"007660","이수페타시스","6870","6970","100","1.46","25511580","186440307450"
"005950","이수화학","14500","16150","1650","11.38","6688795","101700646400"
"015020","이스타코","1275","1495","220","17.25","39239014","57429954180"
"047560","이스트소프트","9680","9940","260","2.69","1075931","10626948610"
"900110","이스트아시아홀딩스","225","228","3","1.33","93097522","21196796555"
"067010","이씨에스","3870","4155","285","7.36","13990552","65598173435"
"093230","이아이디","1280","1505","225","17.58","29777631","43591182435"
"341310","이앤에치","1700","1695","-5","-0.29","48590","75624610"
"101360","이엔드디","23350","28000","4650","19.91","2089332","56288267100"
"102710","이엔에프테크놀로지","27650","29300","1650","5.97","1130760","32220809500"
"066980","이엔코퍼레이션","2915","3210","295","10.12","6697835","21191476355"
"074610","이엔플러스","3075","3165","90","2.93","13030613","42407760895"
"063760","이엘피","5340","5380","40","0.75","990886","5370990220"
"123570","이엠넷","5340","6170","830","15.54","1634540","9348072410"
"083470","이엠앤아이","3220","3220","0","0.00","0","0"
"095190","이엠코리아","2855","3315","460","16.11","4543534","14275223450"
"091120","이엠텍","27150","27000","-150","-0.55","1392780","39166340850"
"232530","이엠티","3050","4485","1435","47.05","59482","154939305"
"102460","이연제약","23250","27300","4050","17.42","8367096","228346726500"
"039030","이오테크닉스","77800","78800","1000","1.29","1612905","125052870300"
"294090","이오플로우","19350","20600","1250","6.46","1629256","32208564900"
"088290","이원컴포텍","8640","9100","460","5.32","2755342","23704531920"
"084680","이월드","1795","1995","200","11.14","33961325","69484768540"
"181340","이즈미디어","2705","2705","0","0.00","0","0"
"353810","이지바이오","4350","4540","190","4.37","26459810","122758204890"
"350520","이지스레지던스리츠","4870","4620","-250","-5.13","1400363","6401456275"
"334890","이지스밸류리츠","5140","5050","-90","-1.75","1349911","6669699700"
"099750","이지케어텍","24500","25050","550","2.24","414685","10610686350"
"377330","이지트로닉스","13350","15600","2250","16.85","8023935","123380603100"
"035810","이지홀딩스","3650","3660","10","0.27","15769760","57187443730"
"160600","이큐셀","3100","3100","0","0.00","0","0"
"092130","이크레더블","17100","17150","50","0.29","154542","2620329450"
"096040","이트론","183","200","17","9.29","278316993","54251363924"
"134060","이퓨쳐","6480","6450","-30","-0.46","341034","2298457140"
"001840","이화공영","5880","6610","730","12.41","9698740","63181601850"
"000760","이화산업","15000","16100","1100","7.33","23092","358437950"
"024810","이화전기","1130","959","-171","-15.13","63164909","62389951905"
"014990","인디에프","780","777","-3","-0.38","1029250","786604160"
"041830","인바디","23100","25750","2650","11.47","680375","16831363850"
"352940","인바이오","5300","6010","710","13.40","612557","3566351120"
"101140","인바이오젠","1830","2185","355","19.40","18496035","42964043935"
"216400","인바이츠바이오코아","8800","8900","100","1.14","6886","60962280"
"079950","인베니아","2005","2100","95","4.74","1806418","3821215190"
"277410","인산가","2010","2155","145","7.21","2367842","4921097840"
"060150","인선이엔티","8490","9630","1140","13.43","14135211","138282258670"
"033230","인성정보","2185","2330","145","6.64","24839373","60585436070"
"006490","인스코비","2195","2110","-85","-3.87","11981003","25548642010"
"037330","인지디스플레","1830","2005","175","9.56","981288","1873155325"
"023800","인지컨트롤스","7260","8280","1020","14.05","1919994","15486601350"
"034590","인천도시가스","25000","27550","2550","10.20","1095395","31562470200"
"211050","인카금융서비스","7950","7620","-330","-4.15","2154167","15647909560"
"083640","인콘","1055","1325","270","25.59","207960283","327338246834"
"216050","인크로스","17700","16400","-1300","-7.34","1655188","26254939300"
"049070","인탑스","28000","31800","3800","13.57","9625882","297140949450"
"119610","인터로조","26750","28650","1900","7.10","1286335","36383063900"
"017250","인터엠","1210","1290","80","6.61","1446520","1867272175"
"129260","인터지스","2810","3020","210","7.47","1782224","5113123110"
"051370","인터플렉스","12700","12650","-50","-0.39","2066934","26626909600"
"064290","인텍플러스","19200","18300","-900","-4.69","2808731","52916996400"
"189300","인텔리안테크","62600","69400","6800","10.86","972002","63817998900"
"150840","인트로메딕","5850","5850","0","0.00","0","0"
"048530","인트론바이오","10450","12450","2000","19.14","8601470","97616076000"
"023810","인팩","8580","8900","320","3.73","473332","4210161320"
"175140","인포마크","7040","7000","-40","-0.57","278821","2021980830"
"115310","인포바인","30300","37350","7050","23.27","8861821","324441678950"
"039290","인포뱅크","13750","14900","1150","8.36","5206887","75923690800"
"071200","인피니트헬스케어","5110","5960","850","16.63","7556582","45820145830"
"101930","인화정공","13750","14950","1200","8.73","578889","8079707000"
"249420","일동제약","33200","39900","6700","20.18","107190498","4663479986150"
"000230","일동홀딩스","25850","31950","6100","23.60","35521840","1114938249600"
"013360","일성건설","3590","4095","505","14.07","31749455","124779129160"
"003120","일성신약","77000","77600","600","0.78","11173","866530100"
"333430","일승","3240","3995","755","23.30","33846130","124988772155"
"068330","일신바이오","3430","3430","0","0.00","0","0"
"003200","일신방직","95500","105000","9500","9.95","108282","10942211900"
"007110","일신석재","1400","1570","170","12.14","10815122","16112825560"
"058450","일야","604","654","50","8.28","6476698","4050675673"
"007570","일양약품","23250","23900","650","2.80","1889947","45668310500"
"007575","일양약품우","25650","25550","-100","-0.39","34445","910542250"
"008500","일정실업","18400","24100","5700","30.98","154487","3359023600"
"019540","일지테크","2475","2795","320","12.93","528274","1368306350"
"081000","일진다이아","19300","23050","3750","19.43","661662","13653922850"
"020760","일진디스플","2135","2005","-130","-6.09","17905752","39414000480"
"020150","일진머티리얼즈","69300","75500","6200","8.95","5960683","428886154700"
"103590","일진전기","6950","5950","-1000","-14.39","18326845","120805924000"
"094820","일진파워","16700","19300","2600","15.57","9690448","167639178800"
"271940","일진하이솔루스","32000","38000","6000","18.75","1691398","57502487000"
"015860","일진홀딩스","6250","6140","-110","-1.76","30916222","206170529720"
"226320","잇츠한불","16250","16650","400","2.46","613935","9964943800"
"950140","잉글우드랩","4810","4790","-20","-0.42","4655546","24123671565"
"049550","잉크테크","6780","6820","40","0.59","309737","2083607690"
"254120","자비스","1795","1865","70","3.90","8212479","15488050015"
"043910","자연과환경","1445","1740","295","20.42","138753947","220902248805"
"234920","자이글","2910","2775","-135","-4.64","260466","708785240"
"289220","자이언트스텝","22950","27500","4550","19.83","11996825","322288291750"
"317400","자이에스앤디","5940","8010","2070","34.85","21940629","181400279650"
"033240","자화전자","23900","24350","450","1.88","6322040","161295918950"
"174880","장원테크","1650","1655","5","0.30","1158576","1942072985"
"049630","재영솔루텍","698","786","88","12.61","4362026","3356081292"
"000950","전방","55500","54100","-1400","-2.52","27246","1514406600"
"110020","전진바이오팜","4480","3985","-495","-11.05","415684","1834769965"
"208140","정다운","2285","2400","115","5.03","3182424","7461503155"
"040420","정상제이엘에스","7460","7590","130","1.74","255208","1908593980"
"045510","정원엔시스","1965","2195","230","11.70","141369957","321391621685"
"217190","제너셈","6230","6260","30","0.48","359935","2225624730"
"095700","제넥신","32900","33350","450","1.37","2490352","82535149750"
"072520","제넨바이오","2290","2190","-100","-4.37","13286592","33661392255"
"122310","제노레이","8070","8920","850","10.53","1868345","16718796050"
"361390","제노코","21400","26200","4800","22.43","3510099","84464427950"
"066830","제노텍","3595","3000","-595","-16.55","11562","35839725"
"187420","제노포커스","5570","6620","1050","18.85","26859296","200150488800"
"225220","제놀루션","12350","12700","350","2.83","5430105","75810224000"
"123330","제닉","3970","5090","1120","28.21","19211109","103727306810"
"159580","제로투세븐","6890","7230","340","4.93","3191248","22479614310"
"147830","제룡산업","2990","3130","140","4.68","1892884","5685905700"
"033100","제룡전기","6980","7390","410","5.87","14618631","107914704120"
"079370","제우스","22900","22750","-150","-0.66","3024869","70702262700"
"054950","제이브이엠","17000","21700","4700","27.65","3368405","66848034600"
"023440","제이스코홀딩스","2350","1995","-355","-15.11","3497875","7828259405"
"090470","제이스텍","5720","6840","1120","19.58","2932125","19335483040"
"287410","제이시스메디칼","7340","7950","610","8.31","9573052","73400098960"
"137950","제이씨케미칼","7820","8550","730","9.34","16150702","139806469720"
"033320","제이씨현시스템","4905","5270","365","7.44","1523667","8014455580"
"348950","제이알글로벌리츠","4505","4680","175","3.88","16023165","72163584115"
"204270","제이앤티씨","5040","5190","150","2.98","389817","2019221980"
"194370","제이에스코퍼레이션","17500","17350","-150","-0.86","1645749","28154383600"
"026040","제이에스티나","2995","3050","55","1.84","840897","2450965070"
"126880","제이엔케이히터","5530","6050","520","9.40","7997206","46930843120"
"322510","제이엘케이","4695","5100","405","8.63","414923","2030692655"
"254160","제이엠멀티","5490","4370","-1120","-20.40","10510","45596420"
"033050","제이엠아이","1100","1160","60","5.45","2614227","2948850265"
"094970","제이엠티","3310","3610","300","9.06","1758200","6130977980"
"058420","제이웨이","2160","2160","0","0.00","0","0"
"025620","제이준코스메틱","972","906","-66","-6.79","10052091","9700700378"
"089790","제이티","6660","7040","380","5.71","2303391","16780293680"
"030000","제일기획","23550","22400","-1150","-4.88","6983751","156478999848"
"052670","제일바이오","1875","1870","-5","-0.27","1430097","2644673785"
"271980","제일약품","21150","23050","1900","8.98","2216749","54828635550"
"001560","제일연마","9060","9390","330","3.64","854865","7895409590"
"199820","제일전기공업","11950","12500","550","4.60","280815","3326803850"
"038010","제일테크노스","7070","7890","820","11.60","3723447","26384009040"
"002620","제일파마홀딩스","12050","13300","1250","10.37","625232","8428801900"
"276730","제주맥주","2170","2405","235","10.83","28256486","68116379855"
"080220","제주반도체","4210","4835","625","14.85","40994444","198398078990"
"006220","제주은행","4395","5320","925","21.05","27888826","166418814465"
"089590","제주항공","15700","15450","-250","-1.59","4334429","65460784491"
"216080","제테마","13800","15650","1850","13.41","501997","7434813800"
"229000","젠큐릭스","9280","9720","440","4.74","590841","5772230510"
"248020","젬","2500","2500","0","0.00","0","0"
"082270","젬백스","13050","15100","2050","15.71","3044481","42087269400"
"064800","젬백스링크","1310","1400","90","6.87","8288590","11339979585"
"044060","조광ILI","2441","1575","-866","-35.48","157607233","531050892950"
"004910","조광페인트","6100","8010","1910","31.31","1717107","12271721850"
"004700","조광피혁","42800","44650","1850","4.32","12837","559672800"
"001550","조비","19500","20800","1300","6.67","812732","15920530150"
"000480","조선내화","79400","77600","-1800","-2.27","22639","1755853600"
"120030","조선선재","152500","160500","8000","5.25","3625626","578294750000"
"034940","조아제약","2875","2950","75","2.61","3206076","9610652790"
"067000","조이시티","4770","5140","370","7.76","34162115","180033942625"
"018470","조일알미늄","1615","2235","620","38.39","205504706","446455076450"
"002600","조흥","174000","183000","9000","5.17","1282","226772500"
"185750","종근당","88800","90900","2100","2.36","406235","36735806900"
"063160","종근당바이오","28800","30400","1600","5.56","539958","16437888550"
"001630","종근당홀딩스","56400","61000","4600","8.16","86160","5053211000"
"033340","좋은사람들","1055","1055","0","0.00","0","0"
"036930","주성엔지니어링","16650","15800","-850","-5.11","20806277","344815798200"
"044380","주연테크","818","890","72","8.80","3800052","3324110287"
"239340","줌인터넷","4005","4315","310","7.74","13063089","57373704020"
"051980","중앙디앤엠","712","698","-14","-1.97","5342833","3912379405"
"072020","중앙백신","12150","12700","550","4.53","337183","4247544200"
"000440","중앙에너비스","21550","21250","-300","-1.39","1556344","33207377500"
"078650","지나인제약","2120","2120","0","0.00","0","0"
"228760","지노믹트리","13350","13150","-200","-1.50","2522763","34042661900"
"314130","지놈앤컴퍼니","18000","21350","3350","18.61","2466273","50942802600"
"013890","지누스","50200","47700","-2500","-4.98","1088166","51536775600"
"389030","지니너스","4103","2950","-1153","-28.10","23551968","110597635415"
"043610","지니뮤직","4100","4470","370","9.02","30063080","147699416145"
"263860","지니언스","7950","9040","1090","13.71","593118","5138649380"
"303030","지니틱스","2320","2650","330","14.22","18535814","47909770925"
"036180","지더블유바이텍","782","878","96","12.28","125246877","143818435953"
"208350","지란지교시큐리티","3835","3930","95","2.48","183924","711453775"
"144510","지씨셀","59200","65600","6400","10.81","2714353","175126719400"
"382480","지아이텍","3005","3440","435","14.48","8930459","29007165410"
"382800","지앤비에스엔지니어링","11650","12100","450","3.86","669216","8089350000"
"299480","지앤이헬스케어","899","896","-3","-0.33","1331","1164102"
"051160","지어소프트","12200","12650","450","3.69","1409212","17109036500"
"053050","지에스이","4565","5290","725","15.88","95841030","494241768440"
"119850","지엔씨에너지","4320","4500","180","4.17","14429304","66721913110"
"270520","지엔원에너지","2565","2750","185","7.21","11846845","32928533210"
"065060","지엔코","567","573","6","1.06","2457366","1395753625"
"204840","지엘팜텍","896","957","61","6.81","10630994","10423752874"
"013870","지엠비코리아","5480","5900","420","7.66","647394","3623179680"
"071320","지역난방공사","31100","33300","2200","7.07","42328","1351199550"
"311320","지오엘리먼트","18200","20000","1800","9.89","2213843","44863973350"
"035000","지투알","5800","6000","200","3.45","152225","909354970"
"388050","지투파워","7388","15500","8112","109.80","26505393","1179785161900"
"219750","지티지웰니스","1425","1425","0","0.00","0","0"
"088790","진도","2920","3335","415","14.21","1085891","3521538405"
"018120","진로발효","23550","24150","600","2.55","112808","2716727850"
"109820","진매트릭스","7830","7680","-150","-1.92","70222265","621775020120"
"086060","진바이오텍","4825","4905","80","1.66","1197928","5784896815"
"036890","진성티이씨","10200","10400","200","1.96","4548202","47185873190"
"363250","진시스템","10150","9840","-310","-3.05","529515","5454724880"
"003780","진양산업","7340","7660","320","4.36","1353856","10109316000"
"007370","진양제약","5990","6170","180","3.01","484980","3009470250"
"010640","진양폴리","5760","6340","580","10.07","1663740","10097975260"
"100250","진양홀딩스","3635","3570","-65","-1.79","864278","3087097920"
"051630","진양화학","3800","4010","210","5.53","776752","2959615320"
"272450","진에어","14550","14800","250","1.72","4247859","60195590650"
"011000","진원생명과학","11150","13300","2150","19.28","70990104","1029516357000"
"250030","진코스텍","4250","4395","145","3.41","25453","102904630"
"002780","진흥기업","1695","1810","115","6.78","23729896","40570802280"
"002787","진흥기업2우B","14900","14900","0","0.00","13517","194553300"
"002785","진흥기업우B","5430","5610","180","3.31","28350","151565130"
"233990","질경이","799","689","-110","-13.77","81968","56912881"
"085660","차바이오텍","15000","16800","1800","12.00","5171705","81842495000"
"261780","차백신연구소","6390","7550","1160","18.15","74678298","595905617120"
"009310","참엔지니어링","837","848","11","1.31","2920637","2420900176"
"158310","참존글로벌","1680","1680","0","0.00","0","0"
"094850","참좋은여행","9700","10100","400","4.12","1276648","12277245530"
"004650","창해에탄올","12000","12900","900","7.50","1808557","22987861300"
"278280","천보","216100","253600","37500","17.35","1205171","281980264000"
"000650","천일고속","63400","66000","2600","4.10","6010","390645600"
"140290","청광건설","592","597","5","0.84","5598","3017261"
"362320","청담글로벌","9150","10750","1600","17.49","90442504","932497225210"
"066360","체리부로","1180","1195","15","1.27","512964","605600890"
"033250","체시스","1030","1105","75","7.28","3044465","3172700702"
"047820","초록뱀미디어","15500","17250","1750","11.29","2872560","46827779100"
"052300","초록뱀컴퍼니","820","890","70","8.54","104778284","102976384224"
"118000","초록뱀헬스케어","974","936","-38","-3.90","13585560","13670703551"
"094360","칩스앤미디어","15400","19000","3600","23.38","2763972","47623168350"
"016790","카나리아바이오","35000","34850","-150","-0.43","42969628","1754051702600"
"016920","카스","2320","2460","140","6.03","34090637","88807369785"
"284620","카이노스메드","9353","7190","-2163","-23.13","2695259","21665296110"
"035720","카카오","71800","83900","12100","16.85","39142968","2963656199776"
"293490","카카오게임즈","49000","60000","11000","22.45","22905668","1246446190500"
"323410","카카오뱅크","31300","32400","1100","3.51","31491875","983920553400"
"377300","카카오페이","65300","74700","9400","14.40","11748391","801323214200"
"042000","카페24","12500","13400","900","7.20","1466054","18890346800"
"006380","카프로","2880","3025","145","5.03","1648851","4742764755"
"317530","캐리소프트","6360","6380","20","0.31","1959163","14455110060"
"071850","캐스텍코리아","1920","2120","200","10.42","558481","1115532065"
"050110","캠시스","2300","2725","425","18.48","427400770","1119117725565"
"223310","커머스마이너","3320","3320","0","0.00","0","0"
"109070","컨버즈","4100","4100","0","0.00","0","0"
"900310","컬러레이","1010","1055","45","4.46","5869179","5887453642"
"078340","컴투스","75100","86600","11500","15.31","3543115","282821708800"
"063080","컴투스홀딩스","53600","63300","9700","18.10","5211316","309665807000"
"307930","컴퍼니케이","6050","6390","340","5.62","1065995","6738139410"
"079190","케스피온","1275","1375","100","7.84","4341792","5818719665"
"263700","케어랩스","6220","6710","490","7.88","4020884","28358519200"
"214370","케어젠","99600","143800","44200","44.38","2197861","277672074500"
"221980","케이디켐","14250","14700","450","3.16","1265035","19483337600"
"001620","케이비아이동국실업","603","668","65","10.78","1816608","1167101706"
"342550","케이비제20호스팩","2290","2290","0","0.00","0","0"
"424140","케이비제21호스팩","2105","2110","5","0.24","604357","1274647705"
"192250","케이사인","1760","2050","290","16.48","49804399","101166598165"
"029460","케이씨","20000","17950","-2050","-10.25","660150","12439793800"
"115500","케이씨에스","6270","6800","530","8.45","11083634","77864964320"
"281820","케이씨텍","17900","16450","-1450","-8.10","594937","10265750300"
"089150","케이씨티","5550","5720","170","3.06","5693389","32540719030"
"025880","케이씨피드","3795","3500","-295","-7.77","6419747","22718402235"
"093320","케이아이엔엑스","50000","57300","7300","14.60","254078","13859110750"
"073010","케이에스피","2160","2095","-65","-3.01","1515564","3136671310"
"105330","케이엔더블유","9170","10800","1630","17.78","780051","7791702090"
"272110","케이엔제이","11400","11050","-350","-3.07","378860","4196746700"
"039420","케이엘넷","2830","2990","160","5.65","5388075","16635730075"
"083550","케이엠","6410","7350","940","14.66","9623104","75781167900"
"032500","케이엠더블유","27150","31700","4550","16.76","3130195","96555184450"
"225430","케이엠제약","1570","1710","140","8.92","4266519","7564310140"
"102370","케이옥션","12300","7230","-5070","-41.22","24660218","225131623380"
"381970","케이카","20000","22400","2400","12.00","11574742","251449478000"
"145270","케이탑리츠","1075","1140","65","6.05","2750111","2925862440"
"036030","케이티알파","5290","6560","1270","24.01","31336879","209447682840"
"064820","케이프","4195","4765","570","13.59","8391532","41468550210"
"347140","케이프이에스제4호","2120","2100","-20","-0.94","81904","172205975"
"256940","케이피에스","5710","6280","570","9.98","679624","4252406810"
"024880","케이피에프","7130","9540","2410","33.80","73442751","626730194730"
"042040","케이피엠테크","582","545","-37","-6.36","32866792","18313599995"
"054410","케이피티유","5750","6030","280","4.87","189611","1119657870"
"258610","케일럼","4670","4340","-330","-7.07","1559936","6582387030"
"274090","켄코아에어로스페이스","10700","11550","850","7.94","1184094","13330033900"
"402420","켈스","14950","14800","-150","-1.00","1364","18965200"
"217600","켐온","2765","2875","110","3.98","81361197","247140289140"
"089010","켐트로닉스","19000","21900","2900","15.26","1013618","20762940350"
"220260","켐트로스","6940","10050","3110","44.81","36394453","345216371330"
"176590","코나솔","5340","6190","850","15.92","72780","445938750"
"052400","코나아이","17000","17900","900","5.29","1270866","22060197850"
"402030","코난테크놀로지","35500","25800","-9700","-27.32","8509289","260747474250"
"391710","코닉오토메이션","2690","4395","1705","63.38","45509680","169275787065"
"046070","코다코","1270","1305","35","2.76","1874611","2463281285"
"047770","코데즈컴바인","1860","2290","430","23.12","123814710","301351759495"
"078940","코드네이처","1665","1445","-220","-13.21","1740952","2604532015"
"080530","코디","1400","1555","155","11.07","1361274","2115037455"
"224060","코디엠","865","863","-2","-0.23","14789321","3055804774"
"417310","코람코더원리츠","5470","5410","-60","-1.10","852181","4454046100"
"357120","코람코에너지리츠","5800","5570","-230","-3.97","2586895","14256305660"
"104540","코렌텍","10350","10750","400","3.86","877410","8978286750"
"027050","코리아나","2950","3020","70","2.37","2215305","6593613115"
"290510","코리아센터","5040","5640","600","11.90","4000391","21318181190"
"007815","코리아써우","8010","8100","90","1.12","52057","424897050"
"007810","코리아써키트","19200","18650","-550","-2.86","5298485","105264138750"
"00781K","코리아써키트2우B","8550","8600","50","0.58","9785","83756180"
"190650","코리아에셋투자증권","9650","9920","270","2.80","2309047","24453407920"
"101670","코리아에스이","2055","2275","220","10.71","5579414","12146125050"
"123410","코리아에프티","2795","2915","120","4.29","4129488","11786019105"
"003690","코리안리","8510","8680","170","2.00","2621447","22908355390"
"036690","코맥스","3515","3795","280","7.97","649009","2344400985"
"049430","코메론","8920","9410","490","5.49","425860","3940815680"
"183300","코미코","47600","45700","-1900","-3.99","775225","36856361750"
"041960","코미팜","7190","7930","740","10.29","1947517","14116566030"
"089890","코세스","8620","10100","1480","17.17","4530158","44959584330"
"009730","코센","2715","2715","0","0.00","0","0"
"189350","코셋","2245","2185","-60","-2.67","4642","8602665"
"082660","코스나인","965","996","31","3.21","11719284","12102823356"
"192820","코스맥스","61700","67300","5600","9.08","2152678","146274392250"
"044820","코스맥스비티아이","9710","9430","-280","-2.88","551925","5166021240"
"222040","코스맥스엔비티","4480","5020","540","12.05","1591881","7649518550"
"241710","코스메카코리아","9730","9740","10","0.10","411460","4005342140"
"005070","코스모신소재","49650","62200","12550","25.28","18161232","1010463643300"
"005420","코스모화학","14650","22350","7700","52.56","49967798","940804476200"
"069110","코스온","2630","2630","0","0.00","0","0"
"169670","코스텍시스템","9600","11500","1900","19.79","126017","1369505150"
"071950","코아스","995","987","-8","-0.80","1428187","1383738549"
"166480","코아스템","10800","11150","350","3.24","606815","7041406850"
"045970","코아시아","6350","7430","1080","17.01","4380807","31669934910"
"196450","코아시아옵틱스","2000","1915","-85","-4.25","3137371","5966050935"
"029960","코엔텍","8210","8680","470","5.72","7617191","67170663810"
"002020","코오롱","22850","25750","2900","12.69","598705","14643992650"
"003070","코오롱글로벌","15800","18600","2800","17.72","3310371","63692973150"
"003075","코오롱글로벌우","27950","30350","2400","8.59","114138","3736496100"
"102940","코오롱생명과학","32800","39950","7150","21.80","881267","32753930700"
"002025","코오롱우","16100","17000","900","5.59","778592","15315168500"
"120110","코오롱인더","51700","54500","2800","5.42","2961109","154992293550"
"120115","코오롱인더우","27050","28500","1450","5.36","110131","3091378350"
"950160","코오롱티슈진","8010","8010","0","0.00","0","0"
"138490","코오롱플라스틱","10550","11900","1350","12.80","5648769","63543745930"
"056000","코원플레이","2860","2860","0","0.00","0","0"
"021240","코웨이","64900","64400","-500","-0.77","2426231","155368909200"
"033290","코웰패션","6200","6720","520","8.39","2540194","16384085540"
"056360","코위버","7010","7290","280","3.99","712020","4974283710"
"282880","코윈테크","24400","28500","4100","16.80","1412984","38040629150"
"121850","코이즈","3130","3830","700","22.36","43028639","160850882880"
"015710","코콤","4955","5170","215","4.34","338084","1718915775"
"052330","코텍","8620","9720","1100","12.76","1287404","12097415470"
"322780","코퍼스코리아","2365","2750","385","16.28","33065338","89018279565"
"126600","코프라","6420","6450","30","0.47","16571484","114109165150"
"036420","콘텐트리중앙","35750","41950","6200","17.34","3538001","132585011750"
"200130","콜마비앤에이치","26700","27600","900","3.37","1344555","36206562700"
"031820","콤텍시스템","770","861","91","11.82","9858473","7944545845"
"294570","쿠콘","32800","34950","2150","6.55","900326","30153472400"
"192400","쿠쿠홀딩스","15900","17000","1100","6.92","873196","14393482350"
"284740","쿠쿠홈시스","28150","31200","3050","10.83","381929","11397924950"
"317690","퀀타매트릭스","6010","6520","510","8.49","2824043","18997969300"
"365270","큐라클","19200","17700","-1500","-7.81","4326893","81100821750"
"060280","큐렉소","7430","8070","640","8.61","1176751","9344871520"
"015590","큐로","390","412","22","5.64","5467190","2217101397"
"040350","큐로컴","1105","1115","10","0.90","7049074","8319912025"
"051780","큐로홀딩스","500","502","2","0.40","4930229","2471194673"
"115180","큐리언트","30300","30300","0","0.00","0","0"
"182360","큐브엔터","13150","13750","600","4.56","1984234","27497549900"
"066310","큐에스아이","12100","12750","650","5.37","2504581","31049874000"
"136660","큐엠씨","2060","2590","530","25.73","9132","19006200"
"016600","큐캐피탈","567","557","-10","-1.76","22805466","12693902954"
"264900","크라운제과","8600","9780","1180","13.72","5003806","51976898880"
"26490K","크라운제과우","11000","12450","1450","13.18","1035588","13616081300"
"005740","크라운해태홀딩스","7110","7500","390","5.49","3536463","30068146030"
"005745","크라운해태홀딩스우","11450","11700","250","2.18","129854","1631528950"
"259960","크래프톤","237000","259000","22000","9.28","3969163","977477470000"
"096240","크레버스","23850","24300","450","1.89","426618","10487062900"
"215570","크로넥스","3200","2750","-450","-14.06","74295","198304770"
"043590","크로바하이텍","1515","1800","285","18.81","7246269","11733237105"
"114120","크루셜텍","1085","1085","0","0.00","0","0"
"110790","크리스에프앤씨","35500","35150","-350","-0.99","591337","20546525150"
"900250","크리스탈신소재","988","1135","147","14.88","80496706","90965371044"
"083790","크리스탈지노믹스","4190","4055","-135","-3.22","3427914","14333073225"
"045520","크린앤사이언스","10150","10350","200","1.97","210118","2209779400"
"036170","클라우드에어","1095","1235","140","12.79","14304343","18096564160"
"214150","클래시스","14500","15550","1050","7.24","6498217","102264861500"
"352770","클리노믹스","7700","8300","600","7.79","2812874","25356904690"
"237880","클리오","14400","14750","350","2.43","1209906","17448466900"
"139670","키네마스터","9290","11100","1810","19.48","5043352","58445182770"
"020120","키다리스튜디오","8260","10150","1890","22.88","28735587","290847287840"
"413600","키움제6호스팩","2275","2170","-105","-4.62","1339627","3002058050"
"039490","키움증권","79600","88900","9300","11.68","1559059","123706807000"
"054780","키이스트","7660","8670","1010","13.19","1188675","9849575760"
"336040","타스컴","19700","18600","-1100","-5.58","2262","42064700"
"219130","타이거일렉","16200","15950","-250","-1.54","727248","11458924100"
"318660","타임기술","2295","1740","-555","-24.18","54480","84223895"
"180060","탑선","13150","12400","-750","-5.70","132195","1626843100"
"065130","탑엔지니어링","5600","6080","480","8.57","442291","2694265820"
"134580","탑코미디어","7350","8870","1520","20.68","1676058","13625157160"
"014580","태경비케이","4125","4525","400","9.70","2673515","11361619905"
"015890","태경산업","6180","6670","490","7.93","7292123","49036290060"
"006890","태경케미컬","14350","13300","-1050","-7.32","6395608","91982790900"
"023160","태광","13050","16700","3650","27.97","10547851","153776826600"
"003240","태광산업","906000","886000","-20000","-2.21","6908","6154388000"
"011280","태림포장","3105","3340","235","7.57","2347653","7802883215"
"323280","태성","1890","1725","-165","-8.73","10695020","19275749730"
"053620","태양","8290","9040","750","9.05","1133555","10087090590"
"004100","태양금속","1415","1410","-5","-0.35","3828171","5242399675"
"004105","태양금속우","2525","2520","-5","-0.20","145020","360062310"
"116100","태양기계","1005","1000","-5","-0.50","15625","15003690"
"009410","태영건설","6760","7090","330","4.88","3680185","25804656970"
"009415","태영건설우","9700","11600","1900","19.59","1896858","22681750820"
"044490","태웅","9930","11150","1220","12.29","1465987","14870902450"
"124560","태웅로직스","5460","5170","-290","-5.31","11882084","60789118130"
"001420","태원물산","4950","5060","110","2.22","236792","1192730800"
"007980","태평양물산","1845","1815","-30","-1.63","1980230","3488343565"
"191420","테고사이언스","21700","20700","-1000","-4.61","381092","8107233450"
"073640","테라사이언스","1855","1720","-135","-7.28","9550791","16961476980"
"182690","테라셈","1440","1440","0","0.00","0","0"
"066700","테라젠이텍스","4455","4865","410","9.20","5950699","29005003420"
"095610","테스","20000","20300","300","1.50","1931448","38947747550"
"055490","테이팩스","68600","80200","11600","16.91","466975","34385651300"
"308700","테크엔","726","695","-31","-4.27","6718","4170539"
"089030","테크윙","7544","8120","576","7.64","9414708","139834118410"
"258050","테크트랜스","1185","1200","15","1.27","30924","34857800"
"054450","텔레칩스","14400","15450","1050","7.29","4151017","64225493400"
"091440","텔레필드","4130","3920","-210","-5.08","1316739","5294976405"
"078000","텔코웨어","9470","9850","380","4.01","60552","581673520"
"200230","텔콘RF제약","1540","1510","-30","-1.95","7527531","11542269340"
"214420","토니모리","4220","4140","-80","-1.90","2614423","11081968020"
"393210","토마토시스템","11850","10700","-1150","-9.70","5588","61575130"
"215480","토박스코리아","4610","4930","320","6.94","746397","3547164640"
"051360","토비스","9100","9250","150","1.65","1663527","15226598940"
"045340","토탈소프트","6140","6390","250","4.07","11437079","77755605340"
"108230","톱텍","7240","7780","540","7.46","1109078","8202459570"
"079970","투비소프트","1080","965","-115","-10.65","4183452","4139088740"
"199800","툴젠","70500","68700","-1800","-2.55","644760","44890364000"
"105550","트루윈","2580","2760","180","6.98","28612761","84368663335"
"290090","트윔","16400","19200","2800","17.07","1123047","20783656450"
"026150","특수건설","8650","11500","2850","32.95","13001732","139216191860"
"322180","티라유텍","8810","9250","440","4.99","218063","1989145130"
"117730","티로보틱스","7090","7990","900","12.69","12307467","96625833320"
"033830","티비씨","989","1085","96","9.71","10923810","11423497159"
"057680","티사이언티픽","2415","3200","785","32.51","49794701","159922658880"
"064760","티씨케이","113700","116600","2900","2.55","685178","82293310950"
"246710","티앤알바이오팹","15500","19850","4350","28.06","7443600","144022503600"
"340570","티앤엘","33700","37400","3700","10.98","1543079","55309303050"
"043220","티에스넥스젠","1130","1185","55","4.87","10071287","11773217860"
"277880","티에스아이","9580","10500","920","9.60","1510778","15139304410"
"131290","티에스이","60700","58100","-2600","-4.28","3114914","188034271500"
"019180","티에이치엔","3040","3290","250","8.22","1149464","3630486095"
"356860","티엘비","37150","41000","3850","10.36","1432394","56711113950"
"062860","티엘아이","7000","7060","60","0.86","254562","1759256940"
"363280","티와이홀딩스","18400","18900","500","2.72","1199158","21929717850"
"36328K","티와이홀딩스우","16450","18150","1700","10.33","55433","928944750"
"321550","티움바이오","16350","16900","550","3.36","1633234","28698821400"
"091810","티웨이항공","1990","2025","35","1.76","8741522","17440550750"
"004870","티웨이홀딩스","545","539","-6","-1.10","4780406","2548544570"
"104480","티케이케미칼","4060","4420","360","8.87","8858588","36794954050"
"081150","티플랙스","4290","4830","540","12.59","40793183","192712634130"
"130740","티피씨글로벌","2900","3195","295","10.17","2754587","8594225430"
"217880","틸론","11000","12800","1800","16.36","31255","350068740"
"084730","팅크웨어","13750","16950","3200","23.27","4280845","67970391850"
"046210","파나진","3105","2995","-110","-3.54","987062","3082537095"
"058530","파나케이아","1620","1620","0","0.00","0","0"
"034230","파라다이스","13700","15000","1300","9.49","11465184","154078485700"
"033540","파라텍","1555","1340","-215","-13.83","25572458","36536117920"
"043200","파루","1030","1175","145","14.08","6329096","6924411943"
"214450","파마리서치","65600","69300","3700","5.64","1746624","118797082300"
"217950","파마리서치바이오","32850","34000","1150","3.50","10901","351517150"
"208340","파멥신","4190","3805","-385","-9.19","4642304","17837045400"
"005690","파미셀","12200","13600","1400","11.48","24840822","326679767050"
"177830","파버나인","3890","4140","250","6.43","1652550","6682564735"
"037070","파세코","16650","14050","-2600","-15.62","3479049","52932349450"
"150900","파수","8960","9830","870","9.71","561398","5224678600"
"037030","파워넷","3765","4515","750","19.92","18170010","79510705865"
"047310","파워로직스","5770","6500","730","12.65","7627281","48955656380"
"266870","파워풀엑스","1295","1300","5","0.39","17735","23918350"
"368770","파이버프로","3790","4330","540","14.25","9790051","40643569960"
"170790","파이오링크","10900","11650","750","6.88","183927","2089610050"
"049120","파인디앤씨","1795","1945","150","8.36","4496457","8830902320"
"038950","파인디지털","5460","6030","570","10.44","5608027","32725259800"
"106240","파인테크닉스","11150","11150","0","0.00","13030911","152446471450"
"131760","파인텍","1100","1220","120","10.91","4336005","5074011880"
"065690","파커스","2595","2790","195","7.51","281112","750252540"
"140860","파크시스템스","97500","97000","-500","-0.51","563196","54318674500"
"091700","파트론","8560","8720","160","1.87","10126900","85374506920"
"202960","판도라티비","1385","1885","500","36.10","65136","107257275"
"032800","판타지오","640","760","120","18.75","10951647","8412646111"
"318010","팜스빌","12500","13550","1050","8.40","439007","5633171050"
"036580","팜스코","4985","5340","355","7.12","2352878","11825214195"
"027710","팜스토리","2825","2435","-390","-13.81","44285588","115915625200"
"004720","팜젠사이언스","7640","7760","120","1.57","4925752","41230101860"
"225590","패션플랫폼","1440","1610","170","11.81","14592242","24400955115"
"054300","팬스타엔터프라이즈","727","742","15","2.06","3243484","2329123426"
"068050","팬엔터테인먼트","3380","3755","375","11.09","4013919","14894463210"
"028670","팬오션","5590","5690","100","1.79","53844610","295886386420"
"222110","팬젠","6610","7460","850","12.86","509596","3887609140"
"010820","퍼스텍","3350","3980","630","18.81","98504012","387555453400"
"016800","퍼시스","32950","31600","-1350","-4.10","87104","2771547100"
"263750","펄어비스","52600","59400","6800","12.93","8577187","473900612700"
"251970","펌텍코리아","14900","16250","1350","9.06","294345","4646450500"
"001020","페이퍼코리아","1840","1785","-55","-2.99","10345209","18028652115"
"327610","펨토바이오메드","13900","13600","-300","-2.16","19946","280726700"
"087010","펩트론","10250","9340","-910","-8.88","1601924","15554230760"
"090080","평화산업","1380","1705","325","23.55","88631683","161977132760"
"010770","평화홀딩스","3300","3740","440","13.33","5063561","20790904535"
"119500","포메탈","4710","5240","530","11.25","7192017","36684036950"
"389140","포바이포","21650","20050","-1600","-7.39","18845907","436740005700"
"022100","포스코 ICT","5260","6120","860","16.35","16073064","91205988995"
"058430","포스코스틸리온","33450","39900","6450","19.28","1581090","59553553150"
"009520","포스코엠텍","5520","7250","1730","31.34","82278650","557701237260"
"047050","포스코인터내셔널","18350","22450","4100","22.34","15600530","308788112300"
"003670","포스코케미칼","109000","160500","51500","47.25","15944353","2146468113000"
"189690","포시에스","7320","7270","-50","-0.68","551195","3917868460"
"318020","포인트모바일","18100","18100","0","0.00","0","0"
"256630","포인트엔지니어링","2700","2535","-165","-6.11","948136","2459430145"
"331380","포커스에이치엔에스","2490","2585","95","3.82","1079740","2776131630"
"234100","폴라리스세원","2085","2380","295","14.15","48360616","115967455655"
"041020","폴라리스오피스","1360","1550","190","13.97","4153940","6394110820"
"114630","폴라리스우노","4045","4440","395","9.77","15420299","73337936970"
"290720","푸드나무","20350","24600","4250","20.88","1283236","30302369550"
"005670","푸드웰","6200","6910","710","11.45","4368784","31161895790"
"094940","푸른기술","8150","8530","380","4.66","1913829","15995403630"
"007330","푸른저축은행","8670","10450","1780","20.53","6035919","64259602090"
"017810","풀무원","12550","14600","2050","16.33","1544959","20814441750"
"093380","풍강","4070","4325","255","6.27","721876","3032977855"
"023900","풍국주정","15100","15500","400","2.65","378759","5753367200"
"103140","풍산","24150","27950","3800","15.73","2580056","67201159150"
"005810","풍산홀딩스","25000","28000","3000","12.00","429677","11348471200"
"371950","풍원정밀","15300","13750","-1550","-10.13","1665799","24955466600"
"370090","퓨런티어","30700","27550","-3150","-10.26","9601383","270815732600"
"220100","퓨쳐켐","16950","16200","-750","-4.42","2155985","35132233250"
"035200","프럼파스트","4235","4690","455","10.74","8699641","40793918370"
"334970","프레스티지바이오로직스","4480","4680","200","4.46","16665051","82250333650"
"950210","프레스티지바이오파마","11750","12000","250","2.13","3525216","43827676500"
"203690","프로스테믹스","2370","2020","-350","-14.77","3760144","7822345460"
"321260","프로이천","2020","2320","300","14.85","13645830","31518834040"
"303360","프로테옴텍","4490","6350","1860","41.43","70212","400159700"
"053610","프로텍","22250","24750","2500","11.24","1111523","26524214300"
"377220","프롬바이오","8640","9950","1310","15.16","24865108","243517399480"
"335810","프리시젼바이오","7190","8060","870","12.10","2901366","24067924170"
"053160","프리엠스","9620","9040","-580","-6.03","1881617","17783825530"
"041590","플래스크","1515","2135","620","40.92","35886387","65038189710"
"367000","플래티어","12550","13300","750","5.98","777220","10097784250"
"075130","플랜티넷","2700","2980","280","10.37","1054786","2995337525"
"222670","플럼라인생명과학","5140","5130","-10","-0.19","6953","36326040"
"009810","플레이그램","1220","1080","-140","-11.48","31443038","43915216475"
"237820","플레이디","5340","5970","630","11.80","1256360","7531733460"
"023770","플레이위드","8620","8520","-100","-1.16","2468574","21181534830"
"300080","플리토","30400","40950","10550","34.70","400356","15046093450"
"150440","피노텍","994","994","0","0.00","0","0"
"032580","피델릭스","1450","1615","165","11.38","11136064","17789653170"
"051380","피씨디렉트","14750","13900","-850","-5.76","4983849","82018737500"
"241820","피씨엘","21800","18600","-3200","-14.68","2533028","58176930950"
"237750","피앤씨테크","7630","6740","-890","-11.66","5460015","39806657440"
"024850","피에스엠씨","1025","1020","-5","-0.49","2007779","2049389991"
"319660","피에스케이","38800","35600","-3200","-8.25","3627907","136699772750"
"031980","피에스케이홀딩스","9140","8860","-280","-3.06","1457452","13465680120"
"002230","피에스텍","4200","4075","-125","-2.98","216575","904677265"
"057880","피에이치씨","1740","1740","0","0.00","0","0"
"043370","피에이치에이","7160","7170","10","0.14","1523612","11746688370"
"242350","피엔아이컴퍼니","5520","6300","780","14.13","70081","406967500"
"239890","피엔에이치테크","17350","16750","-600","-3.46","1129214","19878798750"
"347740","피엔케이피부임상연구센타","3925","6830","2905","74.01","51891140","470522417515"
"137400","피엔티","42200","53800","11600","27.49","5596103","257774326100"
"128660","피제이메탈","3900","4430","530","13.59","7638624","33268338020"
"006140","피제이전자","6250","7910","1660","26.56","5068004","39842099830"
"376180","피코그램","38500","51900","13400","34.81","20150103","915094313050"
"304840","피플바이오","8890","10000","1110","12.49","2957361","32583229290"
"062970","피피아이","2855","2940","85","2.98","420191","1194161890"
"087600","픽셀플러스","7860","8140","280","3.56","135382","1090312520"
"161580","필옵틱스","6950","7920","970","13.96","491507","3568483870"
"347770","핌스","13750","14050","300","2.18","619293","8558233500"
"163730","핑거","11850","12500","650","5.49","828357","10201481600"
"332710","하나금융14호스팩","2295","2295","0","0.00","0","0"
"341160","하나금융15호스팩","2280","2065","-215","-9.43","2073213","4344857655"
"343510","하나금융16호스팩","2200","2160","-40","-1.82","125068","272700990"
"388220","하나금융19호스팩","2140","2145","5","0.23","175802","376078835"
"400560","하나금융20호스팩","2280","2215","-65","-2.85","583164","1303917750"
"406760","하나금융21호스팩","2120","2115","-5","-0.24","157488","334544010"
"418170","하나금융22호스팩","2120","2115","-5","-0.24","237956","505826535"
"086790","하나금융지주","37200","39800","2600","6.99","33153446","1212506838565"
"299030","하나기술","51500","54900","3400","6.60","510622","27820903950"
"067310","하나마이크론","13200","12700","-500","-3.79","14468511","190444177850"
"372290","하나머스트7호스팩","2160","2150","-10","-0.46","235137","506236330"
"166090","하나머티리얼즈","43600","37400","-6200","-14.22","3988101","161382954200"
"293480","하나제약","17750","17900","150","0.85","314408","5578669600"
"039130","하나투어","53000","50000","-3000","-5.66","2872423","142652170650"
"136480","하림","3040","2995","-45","-1.48","21807938","64881905580"
"003380","하림지주","8340","8760","420","5.04","4935287","40396229780"
"365590","하이딥","1650","1755","105","6.36","24369080","41549660810"
"149980","하이로닉","7700","7630","-70","-0.91","3044073","22594387500"
"013030","하이록코리아","17100","22300","5200","30.41","2816880","55862031450"
"352820","하이브","164500","178000","13500","8.21","6451567","1089053142000"
"126700","하이비젼시스템","15250","16600","1350","8.85","2467126","39403615100"
"106080","하이소닉","5650","5650","0","0.00","0","0"
"071090","하이스틸","4260","4360","100","2.35","4402973","18445298270"
"377400","하이제6호스팩","2135","2165","30","1.41","244784","524570320"
"400840","하이제7호스팩","2130","2120","-10","-0.47","241529","513195130"
"221840","하이즈항공","4000","4175","175","4.38","1114351","4576578250"
"106190","하이텍팜","10000","9980","-20","-0.20","139401","1376217330"
"019490","하이트론","2470","2470","0","0.00","0","0"
"000080","하이트진로","30650","31450","800","2.61","4793136","144981931850"
"000087","하이트진로2우B","19150","18900","-250","-1.31","39620","736002800"
"000140","하이트진로홀딩스","11250","11700","450","4.00","529051","6193783300"
"000145","하이트진로홀딩스우","14350","15100","750","5.23","3851","56493350"
"373200","하인크코리아","10150","7380","-2770","-27.29","23871923","192491893420"
"066130","하츠","6270","7830","1560","24.88","6641579","51537421360"
"152550","한국ANKOR유전","1570","1595","25","1.59","244521","384839390"
"004590","한국가구","5830","6600","770","13.21","11379794","70986131250"
"036460","한국가스공사","35150","38000","2850","8.11","6849753","244194772350"
"039340","한국경제TV","5900","6230","330","5.59","555465","3349183760"
"005430","한국공항","38400","39100","700","1.82","108536","4091111300"
"071050","한국금융지주","61600","61700","100","0.16","4438388","269580296900"
"071055","한국금융지주우","57900","56100","-1800","-3.11","137449","7710360000"
"034950","한국기업평가","73400","72600","-800","-1.09","24336","1744486200"
"010040","한국내화","3190","3350","160","5.02","625998","2018628325"
"025540","한국단자","51900","58300","6400","12.33","282454","15806806100"
"222980","한국맥널티","6220","6370","150","2.41","5206901","34284311520"
"331660","한국미라클피플사","15150","13000","-2150","-14.19","1525","20711400"
"256840","한국비엔씨","8370","11300","2930","35.01","149512754","1814444026700"
"004090","한국석유","11600","11600","0","0.00","2960503","33343132650"
"025550","한국선재","4305","5010","705","16.38","8938895","42159621180"
"002200","한국수출포장","22950","23800","850","3.70","107098","2403687450"
"002960","한국쉘석유","245500","248500","3000","1.22","18627","4555974000"
"017890","한국알콜","9730","11250","1520","15.62","3111898","32644221800"
"000240","한국앤컴퍼니","12000","13100","1100","9.17","2061037","25268181400"
"080720","한국유니온제약","7220","8230","1010","13.99","629231","4962332010"
"123890","한국자산신탁","3450","3500","50","1.45","2021894","6926781295"
"015760","한국전력","22200","21650","-550","-2.48","21655623","473031686900"
"063570","한국전자금융","5010","5210","200","3.99","1173852","5931523480"
"041460","한국전자인증","5650","6210","560","9.91","5714230","34902767490"
"006200","한국전자홀딩스","1385","1470","85","6.14","3555746","5038393890"
"101680","한국정밀기계","1440","1440","0","0.00","0","0"
"039740","한국정보공학","3795","4300","505","13.31","11953692","50753359695"
"053300","한국정보인증","5790","6050","260","4.49","3377394","20615328100"
"025770","한국정보통신","7540","10400","2860","37.93","17476004","179885369270"
"409570","한국제10호스팩","2165","2145","-20","-0.92","104295","224623635"
"009540","한국조선해양","83300","93200","9900","11.88","4022861","341369008700"
"023350","한국종합기술","7440","7870","430","5.78","12264827","90856421740"
"025890","한국주강","2740","2740","0","0.00","474030","1268825760"
"000970","한국주철관","8120","8340","220","2.71","2406499","20326046780"
"104700","한국철강","6710","7110","400","5.96","1153855","7877008250"
"017960","한국카본","13000","15150","2150","16.54","17946194","250017654050"
"023760","한국캐피탈","779","808","29","3.72","1991299","1582209469"
"054040","한국컴퓨터","3725","3960","235","6.31","1177296","4575013140"
"050540","한국코퍼레이션","822","822","0","0.00","0","0"
"161890","한국콜마","38600","37550","-1050","-2.72","2022177","77245993950"
"024720","한국콜마홀딩스","17300","17000","-300","-1.73","405540","7074778100"
"021650","한국큐빅","3010","3185","175","5.81","2133022","6895492070"
"161390","한국타이어앤테크놀로지","32750","39800","7050","21.53","7516331","262968027800"
"053590","한국테크놀로지","703","767","64","9.10","16752707","13097758525"
"034830","한국토지신탁","1670","1685","15","0.90","18834722","30232863100"
"007280","한국특강","2495","2440","-55","-2.20","1135558","2730711550"
"032300","한국파마","25750","31900","6150","23.88","18083548","660058254900"
"168490","한국패러랠","2135","2180","45","2.11","681721","1488054670"
"037230","한국팩키지","3105","3435","330","10.63","12388156","45328164195"
"010100","한국프랜지","2505","2670","165","6.59","1019161","2567116700"
"047810","한국항공우주","49450","55500","6050","12.23","38372838","2095953877600"
"123690","한국화장품","7210","7260","50","0.69","587007","4195270620"
"003350","한국화장품제조","22400","22250","-150","-0.67","135384","2939981050"
"030520","한글과컴퓨터","17150","16550","-600","-3.50","2653458","45770617850"
"052600","한네트","7080","7830","750","10.59","12952474","100577996590"
"011500","한농화성","12300","14450","2150","17.48","1621627","21417084500"
"002390","한독","17700","18450","750","4.24","306435","5565170150"
"256150","한독크린텍","11000","10750","-250","-2.27","444923","4781863150"
"014790","한라","4015","4775","760","18.93","12692736","56853446860"
"092460","한라IMS","5140","5730","590","11.48","1336584","7213197100"
"060980","한라홀딩스","36250","38300","2050","5.66","333303","12681584800"
"053690","한미글로벌","11550","12400","850","7.36","6379125","74435395900"
"042700","한미반도체","12850","12750","-100","-0.78","10543975","143895633650"
"008930","한미사이언스","41000","41750","750","1.83","1621997","66243555600"
"128940","한미약품","322500","320000","-2500","-0.78","677478","211403025000"
"047080","한빛소프트","3225","3440","215","6.67","1459376","4800145395"
"009240","한샘","60800","54300","-6500","-10.69","1513560","85231589800"
"020000","한섬","30750","29050","-1700","-5.53","1682314","50307118950"
"003680","한성기업","6290","6680","390","6.20","6458978","44173203310"
"105630","한세실업","16900","17200","300","1.78","6886775","115701682100"
"069640","한세엠케이","3370","3535","165","4.90","1038494","4021120965"
"016450","한세예스24홀딩스","5860","5810","-50","-0.85","374588","2194670240"
"010420","한솔PNS","1560","1675","115","7.37","1260814","2014315235"
"009180","한솔로지스틱스","3280","3485","205","6.25","5204633","17329986265"
"070590","한솔인티큐브","1910","1950","40","2.09","990390","1896843020"
"213500","한솔제지","13300","14850","1550","11.65","2731086","38775125750"
"014680","한솔케미칼","214000","214000","0","0.00","1022732","223148504000"
"004710","한솔테크닉스","5170","6180","1010","19.54","6084544","36893820355"
"004150","한솔홀딩스","3080","3415","335","10.88","1831002","5983900125"
"025750","한솔홈데코","1330","1435","105","7.89","11595308","16132448635"
"226440","한송네오텍","1530","1530","0","0.00","0","0"
"042520","한스바이오메드","10150","10700","550","5.42","243888","2582093300"
"004960","한신공영","12150","13050","900","7.41","2420699","29307596550"
"011700","한신기계","9080","9400","320","3.52","40601509","364039746010"
"078350","한양디지텍","12900","14150","1250","9.69","1737604","23429518000"
"045100","한양이엔지","14000","14800","800","5.71","1547115","22493632600"
"001750","한양증권","10450","11250","800","7.66","165520","1777563500"
"001755","한양증권우","15150","17000","1850","12.21","6630","104440400"
"018880","한온시스템","10000","11150","1150","11.50","11488235","119816619670"
"009420","한올바이오파마","17000","17000","0","0.00","3234888","54485093750"
"014130","한익스프레스","5210","5150","-60","-1.15","633840","3269507155"
"046110","한일네트웍스","12000","12450","450","3.75","461286","5619227650"
"024740","한일단조","2745","3350","605","22.04","54524893","180978286980"
"005860","한일사료","6910","5180","-1730","-25.04","42929427","267816914830"
"300720","한일시멘트","13900","15300","1400","10.07","5901285","92878250850"
"123840","한일진공","599","598","-1","-0.17","1484921","902371316"
"002220","한일철강","3920","4280","360","9.18","1278448","5148927705"
"006390","한일현대시멘트","22450","25250","2800","12.47","335345","8454752850"
"003300","한일홀딩스","10800","11250","450","4.17","59353","642360450"
"007770","한일화학","21700","20050","-1650","-7.60","2955915","61253571100"
"051600","한전KPS","38300","41950","3650","9.53","4474167","172944911350"
"052690","한전기술","68000","73100","5100","7.50","5451929","358075480400"
"130660","한전산업","10800","11000","200","1.85","4217786","44304616620"
"107640","한중엔시에스","11500","12950","1450","12.61","1899","22252350"
"002320","한진","28150","26500","-1650","-5.86","677199","18342031150"
"003480","한진중공업홀딩스","4125","4090","-35","-0.85","1378627","5540315015"
"180640","한진칼","59400","60700","1300","2.19","1239114","73612905200"
"18064K","한진칼우","33700","33250","-450","-1.34","30115","985060900"
"005110","한창","970","1160","190","19.59","211588812","236500824658"
"043090","한창바이오텍","1925","4585","2660","138.18","55168960","225464543450"
"079170","한창산업","7640","8530","890","11.65","12699895","117120282340"
"009460","한창제지","1635","1720","85","5.20","5513617","9461001565"
"086960","한컴MDS","12200","17150","4950","40.57","11810314","193836024000"
"372910","한컴라이프케어","5190","5500","310","5.97","3715072","20936103980"
"054920","한컴위드","4990","5280","290","5.81","8182451","45521567065"
"002680","한탑","2470","1860","-610","-24.70","28026462","58861462475"
"000880","한화","24750","30750","6000","24.24","8307038","228648452750"
"00088K","한화3우B","14100","15700","1600","11.35","1101586","16389681850"
"088350","한화생명","2170","2320","150","6.91","32226178","70953074090"
"000370","한화손해보험","4120","4935","815","19.78","15261138","73417465370"
"009830","한화솔루션","34600","46450","11850","34.25","56046423","2302648050250"
"009835","한화솔루션우","35550","49250","13700","38.54","2890720","139743241650"
"272210","한화시스템","12800","15300","2500","19.53","18375595","259758362150"
"012450","한화에어로스페이스","44600","69800","25200","56.50","39638710","2439232095750"
"000885","한화우","33300","37500","4200","12.61","33799","1217894300"
"003530","한화투자증권","3275","3365","90","2.75","21925214","71987900090"
"003535","한화투자증권우","7690","7450","-240","-3.12","227321","1675456520"
"386580","한화플러스제2호스팩","2205","2200","-5","-0.23","406209","891493440"
"195870","해성디에스","56900","56100","-800","-1.41","6314009","370697417800"
"034810","해성산업","10500","11850","1350","12.86","828542","8961438690"
"03481K","해성산업1우","14600","15950","1350","9.25","218480","3345310550"
"076610","해성옵틱스","827","757","-70","-8.46","10705563","8425905644"
"059270","해성티피씨","6280","7810","1530","24.36","11966381","95062333100"
"101530","해태제과식품","7060","7240","180","2.55","3475434","28467990260"
"220180","핸디소프트","4255","4175","-80","-1.88","13394081","67912412970"
"143210","핸즈코퍼레이션","4010","4145","135","3.37","351477","1455259220"
"900270","헝셩그룹","368","343","-25","-6.79","10024233","3524109300"
"214180","헥토이노베이션","14650","15250","600","4.10","484297","7335318500"
"234340","헥토파이낸셜","18950","22450","3500","18.47","985494","21121360000"
"084990","헬릭스미스","19650","18300","-1350","-6.87","3146665","58088334700"
"000720","현대건설","39550","46600","7050","17.83","12686704","532944469150"
"267270","현대건설기계","42600","40250","-2350","-5.52","4157881","162119850900"
"000725","현대건설우","70700","73300","2600","3.68","78167","5419004900"
"170030","현대공업","6940","7900","960","13.83","24496492","189904451620"
"005440","현대그린푸드","7720","7890","170","2.20","2668137","20469310460"
"086280","현대글로비스","180000","181500","1500","0.83","2222589","402802755500"
"042670","현대두산인프라코어","5320","5820","500","9.40","23872875","131426616940"
"064350","현대로템","19300","25100","5800","30.05","153379428","3769823938250"
"079430","현대리바트","11100","11550","450","4.05","630975","7138688500"
"012330","현대모비스","204500","224000","19500","9.54","4885696","1077734551408"
"319400","현대무벡스","3050","3205","155","5.08","23009039","73319066305"
"010620","현대미포조선","80500","107000","26500","32.92","6712513","627531120406"
"048410","현대바이오","24700","28800","4100","16.60","15223070","428152931350"
"052260","현대바이오랜드","11800","14800","3000","25.42","8063106","127922879100"
"069960","현대백화점","67100","67500","400","0.60","1334934","87656031000"
"004560","현대비앤지스틸","12650","14000","1350","10.67","1538001","20551389150"
"004565","현대비앤지스틸우","63300","60900","-2400","-3.79","5844","356518200"
"004310","현대약품","5840","5530","-310","-5.31","58802762","362190735810"
"322000","현대에너지솔루션","32200","55600","23400","72.67","17207953","821822757950"
"041440","현대에버다임","9650","8170","-1480","-15.34","29373180","259982640270"
"039010","현대에이치티","8140","8670","530","6.51","143458","1222484810"
"017800","현대엘리베이","26350","30000","3650","13.85","2576323","70933931850"
"307950","현대오토에버","113500","126000","12500","11.01","1260924","157075241500"
"011210","현대위아","55600","70000","14400","25.90","5913625","375939243500"
"090850","현대이지웰","7580","7750","170","2.24","4400712","35225007100"
"267260","현대일렉트릭","23900","30450","6550","27.41","11466847","295754062050"
"004020","현대제철","32750","34550","1800","5.50","9136930","300781528650"
"329180","현대중공업","125500","139500","14000","11.16","5052176","642091253000"
"005380","현대차","178000","193500","15500","8.71","19881968","3794385158904"
"005387","현대차2우B","86400","92500","6100","7.06","1586604","146444837598"
"005389","현대차3우B","83600","88400","4800","5.74","128483","11385653000"
"005385","현대차우","87000","92100","5100","5.86","915845","84401854800"
"001500","현대차증권","9670","10450","780","8.07","743830","7604385790"
"011760","현대코퍼레이션","15500","17400","1900","12.26","1211818","19886385500"
"227840","현대코퍼레이션홀딩스","10500","11550","1050","10.00","463884","5052720650"
"126560","현대퓨처넷","2505","2830","325","12.97","28325590","84963195205"
"001450","현대해상","30650","33500","2850","9.30","7508527","245977900600"
"057050","현대홈쇼핑","50700","51300","600","1.18","209030","10678271750"
"092300","현우산업","4340","4730","390","8.99","16705562","77614445520"
"138360","협진","4480","4480","0","0.00","0","0"
"011080","형지I&C","872","700","-172","-19.72","3369527","2783466177"
"093240","형지엘리트","1595","1720","125","7.84","8022819","13783424600"
"003010","혜인","8530","7850","-680","-7.97","15005983","117024060580"
"111110","호전실업","8290","9040","750","9.05","751385","6558192440"
"008770","호텔신라","69700","72900","3200","4.59","4116962","289730459000"
"008775","호텔신라우","56800","59600","2800","4.93","35475","2079076200"
"060560","홈센타홀딩스","1270","1475","205","16.14","93733562","131018077885"
"064240","홈캐스트","3575","4780","1205","33.71","5066339","20275323055"
"039610","화성밸브","5340","6750","1410","26.40","17628024","119771100780"
"002460","화성산업","18850","17500","-1350","-7.16","1202886","21094175000"
"378850","화승알앤에이","3470","3480","10","0.29","834672","2849402625"
"241590","화승엔터프라이즈","11750","12200","450","3.83","3753978","44600075250"
"006060","화승인더","4665","5020","355","7.61","2658218","13030077840"
"013520","화승코퍼레이션","1525","1485","-40","-2.62","2856223","4083323775"
"010690","화신","8780","9950","1170","13.33","20120331","198787212450"
"126640","화신정공","1610","1755","145","9.01","8008187","13630408645"
"133820","화인베스틸","2605","3005","400","15.36","3404379","8885151420"
"061250","화일약품","2620","2690","70","2.67","47119833","138113039465"
"010660","화천기계","2570","3220","650","25.29","23923081","77904927835"
"000850","화천기공","31950","34250","2300","7.20","122753","4243562400"
"016580","환인제약","16750","17200","450","2.69","403225","6818355350"
"032560","황금에스티","7320","7770","450","6.15","2471496","18459180740"
"004800","효성","76500","75300","-1200","-1.57","897255","66814027700"
"094280","효성ITX","14300","15000","700","4.90","161230","2383157800"
"097870","효성오앤비","9760","9730","-30","-0.31","4289511","40963443150"
"298040","효성중공업","57100","65900","8800","15.41","1052674","61726311900"
"298050","효성첨단소재","363500","417500","54000","14.86","891064","325504422248"
"298020","효성티앤씨","330000","341500","11500","3.48","766992","245116501500"
"298000","효성화학","176500","188500","12000","6.80","215289","38710510500"
"093370","후성","17700","15800","-1900","-10.73","58754027","995550703000"
"081660","휠라홀딩스","28500","30100","1600","5.61","4515838","133726798250"
"290270","휴네시온","4185","4430","245","5.85","250750","1092186245"
"005870","휴니드","7100","8100","1000","14.08","3842661","29377062810"
"353190","휴럼","1170","1325","155","13.25","10384615","13492490685"
"090710","휴림로봇","3000","3180","180","6.00","405530169","1247886976055"
"205470","휴마시스","18300","18800","500","2.73","124311801","2622848644350"
"115160","휴맥스","3330","3760","430","12.91","13321551","50343959265"
"028080","휴맥스홀딩스","3380","3510","130","3.85","2140205","7877391340"
"032860","휴먼엔","3640","3640","0","0.00","0","0"
"200670","휴메딕스","21600","24450","2850","13.19","1039641","24743086650"
"212310","휴벡셀","6000","5950","-50","-0.83","37076","211954820"
"079980","휴비스","6270","6390","120","1.91","487459","3105427900"
"065510","휴비츠","10950","10650","-300","-2.74","6584709","73185251550"
"215090","휴센텍","1505","1505","0","0.00","0","0"
"005010","휴스틸","4390","4345","-45","-1.03","6623216","27132626475"
"263920","휴엠앤씨","4555","4555","0","0.00","0","0"
"243070","휴온스","35950","38000","2050","5.70","357186","13222491400"
"084110","휴온스글로벌","21800","22850","1050","4.82","1000873","23473133050"
"145020","휴젤","109800","129700","19900","18.12","2414460","303554495400"
"024060","흥구석유","6170","6240","70","1.13","1701245","10453145820"
"010240","흥국","6900","7180","280","4.06","990734","6759637460"
"189980","흥국에프엔비","2910","3195","285","9.79","12025304","38723907840"
"000540","흥국화재","3190","3400","210","6.58","2945567","9472655260"
"000547","흥국화재2우B","22700","22150","-550","-2.42","13346","288922800"
"000545","흥국화재우","7070","7170","100","1.41","17935","126062930"
"003280","흥아해운","2095","1825","-270","-12.89","12589161","23239196885"
"037440","희림","8100","10100","2000","24.69","74922341","677743687460"
"238490","힘스","6240","7670","1430","22.92","3846745","29775643600"