종목코드,종목명,시작일 기준가,종료일 종가,대비,등락률,거래량,거래대금
"060310","3S","2885","2905","20","0.69","13176357","39296000790"
"095570","AJ네트웍스","6520","7860","1340","20.55","2253276","17056610560"
"006840","AK홀딩스","16250","16350","100","0.62","263697","4260788700"
"054620","APS홀딩스","8190","10650","2460","30.04","1931828","18890211810"
"265520","AP시스템","16900","18600","1700","10.06","1531659","26792368000"
"211270","AP위성","11500","11800","300","2.61","6619232","79346358150"
"027410","BGF","4170","4310","140","3.36","2866246","12011698795"
"282330","BGF리테일","189500","173000","-16500","-8.71","807012","146223272500"
"032790","BNGT","4075","4075","0","0.00","0","0"
"138930","BNK금융지주","6630","6830","200","3.02","21521324","142469867446"
"001460","BYC","404500","416000","11500","2.84","2064","853853000"
"001465","BYC우","157000","156000","-1000","-0.64","1365","212689500"
"013720","CBI","1365","1945","580","42.49","50307524","102652263580"
"001040","CJ","77700","80200","2500","3.22","600558","47188788700"
"079160","CJ CGV","21950","21400","-550","-2.51","4697255","98857549000"
"035760","CJ ENM","95800","101000","5200","5.43","1871423","186935650000"
"311690","CJ 바이오사이언스","31450","34600","3150","10.02","434179","14598494350"
"00104K","CJ4우(전환)","70400","71500","1100","1.56","157759","11071594000"
"000120","CJ대한통운","122000","127000","5000","4.10","1112248","129820940500"
"011150","CJ씨푸드","3190","3405","215","6.74","7052179","24033573160"
"011155","CJ씨푸드1우","29750","28550","-1200","-4.03","5054","142095550"
"001045","CJ우","48050","49650","1600","3.33","40871","1967410750"
"097950","CJ제일제당","389000","419000","30000","7.71","968993","391944157500"
"097955","CJ제일제당 우","165500","177000","11500","6.95","30736","5266661000"
"051500","CJ프레시웨이","39150","41400","2250","5.75","1783783","68247839850"
"058820","CMG제약","2620","2855","235","8.97","12373612","33892274440"
"023460","CNH","1795","1945","150","8.36","339560","635332615"
"056730","CNT85","3100","3100","0","0.00","0","0"
"065770","CS","2095","2220","125","5.97","4619678","10324091735"
"083660","CSA 코스믹","1525","1450","-75","-4.92","957162","1400993970"
"000590","CS홀딩스","59400","66200","6800","11.45","231036","15055205300"
"012030","DB","797","833","36","4.52","5318210","4319765674"
"404950","DB금융스팩10호","2100","2110","10","0.48","229011","483320605"
"367340","DB금융스팩8호","2135","2130","-5","-0.23","249157","528821720"
"367360","DB금융스팩9호","2155","2125","-30","-1.39","197265","417593585"
"016610","DB금융투자","5020","5230","210","4.18","671979","3373456120"
"005830","DB손해보험","58200","62800","4600","7.90","3205898","197211522555"
"000990","DB하이텍","49000","42900","-6100","-12.45","20479203","888526242200"
"000995","DB하이텍1우","93700","71100","-22600","-24.12","8669","703823900"
"139130","DGB금융지주","7790","7590","-200","-2.57","7802770","59311749130"
"001530","DI동일","16100","19900","3800","23.60","2037092","36013934000"
"000210","DL","67300","67700","400","0.59","2703313","179578106400"
"001880","DL건설","20750","22000","1250","6.02","447420","9533816650"
"000215","DL우","39100","39650","550","1.41","41589","1641100950"
"375500","DL이앤씨","40250","43900","3650","9.07","4776898","193445887500"
"37550L","DL이앤씨2우(전환)","34250","34950","700","2.04","46897","1596516250"
"37550K","DL이앤씨우","28550","29700","1150","4.03","68380","1968205350"
"068790","DMS","5050","5590","540","10.69","1201123","6451241965"
"007340","DN오토모티브","53000","56000","3000","5.66","411049","21925136350"
"004840","DRB동일","4520","4620","100","2.21","270375","1230758810"
"241520","DSC인베스트먼트","4180","4640","460","11.00","6328891","28987881935"
"155660","DSR","5400","6140","740","13.70","1672332","9552512820"
"069730","DSR제강","4795","5360","565","11.78","1242875","6217006375"
"017940","E1","44950","45100","150","0.33","188652","8310927800"
"245620","EDGC","3280","2855","-425","-12.96","44102229","150122425495"
"037370","EG","9200","10550","1350","14.67","803715","7940169560"
"278990","EMB","5490","5600","110","2.00","17852","90474330"
"365550","ESR켄달스퀘어리츠","5460","5530","70","1.28","5015105","26361177034"
"050120","ES큐브","3900","3840","-60","-1.54","786666","3069207095"
"084180","EV수성","1525","1375","-150","-9.84","22184028","32960287970"
"383220","F&F","138000","155000","17000","12.32","2714748","405983455500"
"007700","F&F홀딩스","18800","19800","1000","5.32","795487","15540955050"
"214270","FSN","4420","5060","640","14.48","21206960","111231172650"
"130500","GH신소재","4910","4960","50","1.02","30712607","171283732065"
"114090","GKL","13950","15000","1050","7.53","5023494","71193460500"
"900290","GRT","1240","1300","60","4.84","2697836","3443140650"
"078930","GS","39650","42750","3100","7.82","3825897","154067802050"
"083450","GST","21750","21850","100","0.46","1596747","35007450750"
"006360","GS건설","29550","32150","2600","8.80","15658720","461993396550"
"001250","GS글로벌","3240","3890","650","20.06","229769717","841971830975"
"007070","GS리테일","25500","25750","250","0.98","4900697","120516828050"
"078935","GS우","34550","34950","400","1.16","58777","2010432550"
"297890","HB솔루션","13100","13550","450","3.44","1158109","15425571600"
"078150","HB테크놀러지","1865","2035","170","9.12","13781484","27847493310"
"012630","HDC","6540","6970","430","6.57","1231568","8250160930"
"039570","HDC랩스","8460","8800","340","4.02","890095","8271562640"
"089470","HDC현대EP","3865","4250","385","9.96","435611","1763237170"
"294870","HDC현대산업개발","11450","13050","1600","13.97","6957124","82882631550"
"267250","HD현대","52900","58400","5500","10.40","3176494","171698929650"
"097230","HJ중공업","6800","6870","70","1.03","276563","1882776460"
"195940","HK이노엔","40150","43800","3650","9.09","12453337","531075889450"
"028300","HLB","40300","47700","7400","18.36","26052187","1142626878950"
"003580","HLB글로벌","10100","9680","-420","-4.16","13462466","131696534720"
"343090","HLB사이언스","4100","4255","155","3.78","320384","1244801470"
"067630","HLB생명과학","13000","14150","1150","8.85","26063413","348037093450"
"047920","HLB제약","15650","16500","850","5.43","7828707","119545197150"
"115450","HLB테라퓨틱스","13400","12100","-1300","-9.70","5131333","64127487400"
"011200","HMM","25100","25350","250","1.00","39381431","954034092950"
"036640","HRS","6190","6720","530","8.56","2674358","16922965970"
"082740","HSD엔진","7298","8690","1392","19.07","9064906","80490340330"
"335870","IBKS제12호스팩","2460","2825","365","14.84","6079242","15326860775"
"351340","IBKS제13호스팩","2030","2015","-15","-0.74","1339490","2762704440"
"388790","IBKS제16호스팩","2225","2225","0","0.00","0","0"
"405350","IBKS제17호스팩","2280","2270","-10","-0.44","458950","1052079215"
"003560","IHQ","719","726","7","0.97","11352892","8560537103"
"095340","ISC","32550","31400","-1150","-3.53","4487075","148099515800"
"099520","ITX-AI","1285","1285","0","0.00","0","0"
"175330","JB금융지주","7130","7380","250","3.51","5815773","42424129150"
"950170","JTC","2845","2695","-150","-5.27","658791","1773214155"
"234080","JW생명과학","13350","13700","350","2.62","270134","3675652450"
"067290","JW신약","3845","4145","300","7.80","8712690","35785624965"
"001060","JW중외제약","24050","23000","-1050","-4.37","1737419","42374678100"
"001067","JW중외제약2우B","70300","70500","200","0.28","2852","202825700"
"001065","JW중외제약우","36600","36550","-50","-0.14","5644","203467550"
"096760","JW홀딩스","3360","3460","100","2.98","704426","2435056190"
"035900","JYP Ent.","53400","57800","4400","8.24","8262331","462938880700"
"318000","KBG","5930","6590","660","11.13","1029938","6441868210"
"024840","KBI메탈","1715","1835","120","7.00","2623997","4723617635"
"105560","KB금융","47000","51300","4300","9.15","25541633","1213880820751"
"024120","KB오토시스","5620","5470","-150","-2.67","1314595","7119329540"
"002380","KCC","287500","307000","19500","6.78","772220","225352686500"
"021320","KCC건설","6870","7280","410","5.97","421417","2894859200"
"344820","KCC글라스","44800","49400","4600","10.27","494267","22788532950"
"036670","KCI","8190","8890","700","8.55","209883","1806078330"
"009070","KCTC","4460","5180","720","16.14","8281986","43574018620"
"009440","KC그린홀딩스","5020","4950","-70","-1.39","2665464","13048393965"
"112190","KC산업","3420","3695","275","8.04","15758","53561315"
"119650","KC코트렐","4230","4630","400","9.46","1188965","5271091895"
"044180","KD","1035","1075","40","3.86","1591595","1627048200"
"092220","KEC","2545","2730","185","7.27","44095719","119231325100"
"151860","KG ETS","15850","15700","-150","-0.95","27266390","418681946700"
"046440","KG모빌리언스","7130","7330","200","2.81","3760560","26277282210"
"016380","KG스틸","13150","12700","-450","-3.42","14601115","181768010250"
"035600","KG이니시스","13700","14100","400","2.92","2473730","33901082050"
"001390","KG케미칼","26100","29200","3100","11.88","7645411","216619538350"
"226360","KH 건설","919","864","-55","-5.98","171472104","151881801299"
"111870","KH 전자","753","821","68","9.03","34449191","26582958454"
"033180","KH 필룩스","1525","1515","-10","-0.66","17025883","25212771935"
"060720","KH바텍","18200","19550","1350","7.42","4451938","89708802050"
"001940","KISCO홀딩스","14050","14250","200","1.42","409060","5713212100"
"058400","KNN","1010","1070","60","5.94","7206245","7516552229"
"114450","KPX생명과학","5280","5610","330","6.25","26522026","170856512830"
"025000","KPX케미칼","47950","51400","3450","7.19","49756","2462274300"
"092230","KPX홀딩스","59600","60500","900","1.51","15296","913980600"
"000040","KR모터스","633","713","80","12.64","57434234","44576083987"
"044450","KSS해운","9650","10850","1200","12.44","686830","6881738830"
"030200","KT","36650","38600","1950","5.32","16018367","601252281875"
"033780","KT&G","80700","81200","500","0.62","5084720","413824965000"
"058850","KTcs","2015","2385","370","18.36","19624157","45156767050"
"058860","KTis","2595","2805","210","8.09","7387988","19824734710"
"060370","KT서브마린","6450","6970","520","8.06","13861893","94389435100"
"122450","KX","7690","7870","180","2.34","984046","7498599360"
"052900","KX하이텍","1380","1510","130","9.42","10256319","15314801970"
"093050","LF","16150","17050","900","5.57","946891","15693656850"
"003550","LG","78400","81600","3200","4.08","3560557","280434934200"
"034220","LG디스플레이","15250","16400","1150","7.54","28283834","432117604250"
"051900","LG생활건강","714000","743000","29000","4.06","1244499","923532970271"
"051905","LG생활건강우","330500","363500","33000","9.98","109352","38333618500"
"373220","LG에너지솔루션","388000","470000","82000","21.13","12420145","5087791604500"
"003555","LG우","61400","62800","1400","2.28","40658","2505399100"
"032640","LG유플러스","12300","12550","250","2.03","15639840","192937110208"
"011070","LG이노텍","338000","342500","4500","1.33","4870412","1678699993000"
"066570","LG전자","92000","95400","3400","3.70","13156804","1226387661100"
"066575","LG전자우","44800","46800","2000","4.46","395723","18085562200"
"037560","LG헬로비전","5610","5480","-130","-2.32","12392382","70068808390"
"051910","LG화학","540000","672000","132000","24.44","6106171","3545887705491"
"051915","LG화학우","254500","328000","73500","28.88","327311","91885442558"
"079550","LIG넥스원","69400","89900","20500","29.54","5611348","464814378200"
"006260","LS","55400","61500","6100","11.01","3057986","169958519800"
"010120","LS ELECTRIC","53200","58900","5700","10.71","3549984","194668360500"
"000680","LS네트웍스","2650","3135","485","18.30","1865940","5572553020"
"229640","LS전선아시아","6920","7370","450","6.50","5771867","42462419140"
"108320","LX세미콘","95500","92400","-3100","-3.25","4550514","426710303500"
"001120","LX인터내셔널","29600","33600","4000","13.51","5914675","184281158150"
"108670","LX하우시스","42100","45200","3100","7.36","529765","22719490950"
"108675","LX하우시스우","20400","21950","1550","7.60","64930","1308091400"
"383800","LX홀딩스","8950","8660","-290","-3.24","2939281","25477263460"
"38380K","LX홀딩스1우","12150","12200","50","0.41","67918","813970850"
"023150","MH에탄올","8550","9080","530","6.20","3313103","31559175370"
"035420","NAVER","249000","268500","19500","7.83","14899016","3758969379594"
"160550","NEW","7150","8500","1350","18.88","7336837","57634784200"
"053290","NE능률","5410","5620","210","3.88","20897683","135673039860"
"181710","NHN","27650","29450","1800","6.51","2252816","63763646400"
"104200","NHN벅스","9070","9280","210","2.32","6655454","63724555620"
"060250","NHN한국사이버결제","12850","13700","850","6.61","14063508","195130062500"
"400760","NH올원리츠","4540","4640","100","2.20","1099425","4900262100"
"005940","NH투자증권","9230","10000","770","8.34","12916885","122521390970"
"005945","NH투자증권우","9210","9920","710","7.71","732591","6957975970"
"338100","NH프라임리츠","4660","4665","5","0.11","621434","2856343675"
"034310","NICE","14600","13400","-1200","-8.22","1154369","16115430250"
"030190","NICE평가정보","14250","16500","2250","15.79","2044101","30925464433"
"008260","NI스틸","4850","5040","190","3.92","2520532","12487587200"
"004250","NPC","8770","9740","970","11.06","38215988","364463195500"
"004255","NPC우","4725","5050","325","6.88","6613984","34742612280"
"010060","OCI","127000","126500","-500","-0.39","14192291","1666192102000"
"178920","PI첨단소재","33850","38750","4900","14.48","2483729","88566649950"
"024940","PN풍년","4910","5720","810","16.50","4700775","24225274405"
"005490","POSCO홀딩스","231000","253000","22000","9.52","5975197","1400110728130"
"218410","RFHIC","21900","23600","1700","7.76","2138694","48222987000"
"327260","RF머트리얼즈","11150","10800","-350","-3.14","347551","3828733000"
"091340","S&K폴리텍","4235","4500","265","6.26","192289","835359660"
"010950","S-Oil","93000","86400","-6600","-7.10","9538002","854554483772"
"010955","S-Oil우","58000","56800","-1200","-2.07","301111","17269457900"
"019550","SBI인베스트먼트","1550","1470","-80","-5.16","20720834","30100855370"
"950110","SBI핀테크솔루션즈","4305","4830","525","12.20","125706","578463330"
"034120","SBS","42600","43500","900","2.11","937208","39009569550"
"046140","SBS콘텐츠허브","6030","7020","990","16.42","2104861","14834714070"
"151910","SBW생명과학","3800","3245","-555","-14.61","5374498","19235053340"
"036120","SCI평가정보","3340","2965","-375","-11.23","18456940","62563417475"
"099220","SDN","2510","3045","535","21.31","275867763","809201216475"
"036540","SFA반도체","5140","5340","200","3.89","34565629","185123763945"
"255220","SG","1595","1775","180","11.29","25932090","47905285555"
"040610","SG&G","1995","2145","150","7.52","9348771","19977007005"
"049470","SGA","943","940","-3","-0.32","4114243","3861779710"
"184230","SGA솔루션즈","865","982","117","13.53","36921920","37706095964"
"005090","SGC에너지","33600","38400","4800","14.29","1512950","54103437650"
"016250","SGC이테크건설","43500","50300","6800","15.63","113910","5294159250"
"001380","SG글로벌","1360","1490","130","9.56","2796387","4134819465"
"004060","SG세계물산","560","618","58","10.36","16701176","9834993564"
"001770","SHD","30050","32150","2100","6.99","200639","6093627350"
"002360","SH에너지화학","1000","1110","110","11.00","104042371","111288328867"
"009160","SIMPAC","6250","6580","330","5.28","2768932","17368987410"
"123700","SJM","3500","3665","165","4.71","187772","676889715"
"025530","SJM홀딩스","3005","3130","125","4.16","1323017","4004914695"
"034730","SK","208500","228500","20000","9.59","2520770","543278520488"
"337450","SK5호스팩","5040","3400","-1640","-32.54","64368432","322732135545"
"340350","SK6호스팩","2265","2115","-150","-6.62","7888943","17130508965"
"011790","SKC","132000","133000","1000","0.76","4326358","569903626500"
"018670","SK가스","112000","117000","5000","4.46","259998","29028331500"
"001740","SK네트웍스","4250","4375","125","2.94","8245386","35948136225"
"001745","SK네트웍스우","57600","61800","4200","7.29","5168","304124400"
"006120","SK디스커버리","34800","36400","1600","4.60","336894","11974063250"
"006125","SK디스커버리우","30250","30800","550","1.82","35948","1095984850"
"210980","SK디앤디","24800","28300","3500","14.11","461035","11748631600"
"068400","SK렌터카","8260","8860","600","7.26","3409748","31764898610"
"395400","SK리츠","5710","5480","-230","-4.03","6689144","35893311070"
"302440","SK바이오사이언스","140000","124000","-16000","-11.43","20580882","2812174518500"
"326030","SK바이오팜","78800","81000","2200","2.79","2090430","164456159800"
"402340","SK스퀘어","39800","43450","3650","9.17","6690696","277966001770"
"260870","SK시그넷","48350","50800","2450","5.07","156450","8096427300"
"361610","SK아이이테크놀로지","82000","93700","11700","14.27","11028274","928379513700"
"03473K","SK우","184500","196000","11500","6.23","13525","2511826000"
"096770","SK이노베이션","171500","194000","22500","13.12","8266784","1491720658500"
"096775","SK이노베이션우","110500","120000","9500","8.60","44810","5113779500"
"001510","SK증권","726","774","48","6.61","21293947","15877364997"
"001515","SK증권우","2980","3095","115","3.86","113318","341043145"
"285130","SK케미칼","102000","106500","4500","4.41","1318193","138048351500"
"28513K","SK케미칼우","51700","53100","1400","2.71","141037","7450896500"
"017670","SK텔레콤","54000","52700","-1300","-2.41","11010712","590192099201"
"000660","SK하이닉스","94800","94000","-800","-0.84","66218827","6474287335862"
"048550","SM C&C","3350","4090","740","22.09","50750326","197652122275"
"063440","SM Life Design","2130","2395","265","12.44","20463782","48247806135"
"064960","SNT모티브","41000","42100","1100","2.68","805906","34601852250"
"100840","SNT에너지","16550","17700","1150","6.95","606399","9854990450"
"003570","SNT중공업","6800","9140","2340","34.41","11008623","92263994520"
"036530","SNT홀딩스","15450","15550","100","0.65","494917","7925246350"
"005610","SPC삼립","80900","86300","5400","6.67","307886","25158700900"
"011810","STX","3275","3535","260","7.94","763528","2520631320"
"077970","STX엔진","13200","15700","2500","18.94","2815706","40816439150"
"071970","STX중공업","4260","4685","425","9.98","1447058","6260853570"
"002820","SUN&L","4590","4555","-35","-0.76","281807","1256599280"
"289080","SV인베스트먼트","2655","2905","250","9.42","21151909","62256643355"
"084870","TBH글로벌","1980","2055","75","3.79","1929743","3925772940"
"002710","TCC스틸","12600","14250","1650","13.10","16818363","228448697600"
"089230","THE E&M","456","543","87","19.08","32059695","17261664165"
"161570","THE MIDONG","1235","1255","20","1.62","759778","936485130"
"192410","THQ","4765","4550","-215","-4.51","8045904","38634757775"
"032540","TJ미디어","5830","6620","790","13.55","3429155","22061426210"
"022220","TKG애강","1880","1880","0","0.00","26628195","51798845190"
"069260","TKG휴켐스","19900","20150","250","1.26","3186254","62391718800"
"048770","TPC","4795","4890","95","1.98","15421819","75912884660"
"246690","TS인베스트먼트","2580","2340","-240","-9.30","34366239","83236845930"
"317240","TS트릴리온","853","872","19","2.23","7623392","6455525730"
"002900","TYM","2510","2425","-85","-3.39","166416723","428411285000"
"038340","UCI","1335","1335","0","0.00","0","0"
"073570","WI","1020","920","-100","-9.80","13732369","13578076063"
"024070","WISCOM","3300","3200","-100","-3.03","373218","1191211240"
"057030","YBM넷","4060","4690","630","15.52","16881145","87175111815"
"037270","YG PLUS","5470","6810","1340","24.50","17972412","112197487450"
"040300","YTN","3650","3620","-30","-0.82","276455","993626070"
"051390","YW","3680","3850","170","4.62","217782","814304475"
"052220","iMBC","3180","3460","280","8.81","1174451","3810308620"
"079940","가비아","11100","12200","1100","9.91","438138","5094503850"
"078890","가온미디어","8470","8390","-80","-0.94","3984365","33825474680"
"000500","가온전선","23150","20950","-2200","-9.50","385099","8442405000"
"399720","가온칩스","24650","27150","2500","10.14","13093423","337045644850"
"036620","감성코퍼레이션","1625","1770","145","8.92","9772017","16977345000"
"000860","강남제비스코","21050","23450","2400","11.40","152828","3425437200"
"217730","강스템바이오텍","2845","3900","1055","37.08","5091286","17995211465"
"035250","강원랜드","25450","25650","200","0.79","10567448","261840008350"
"114190","강원에너지","6370","5130","-1240","-19.47","6888994","38219380600"
"094480","갤럭시아머니트리","6080","7510","1430","23.52","39269381","301840893230"
"011420","갤럭시아에스엠","1865","2040","175","9.38","7105438","13858117055"
"039240","경남스틸","3275","3625","350","10.69","2914673","9824912095"
"053950","경남제약","2655","2550","-105","-3.95","19815234","57485140835"
"002100","경농","10850","11600","750","6.91","943389","10513659500"
"009450","경동나비엔","38450","38800","350","0.91","767016","30176514000"
"267290","경동도시가스","20550","23650","3100","15.09","1339440","30454985250"
"012320","경동인베스트","34000","34450","450","1.32","63599","2227329150"
"011040","경동제약","8930","8840","-90","-1.01","1657252","15036725840"
"000050","경방","12300","13100","800","6.50","107933","1389425450"
"214390","경보제약","7140","7170","30","0.42","277841","1997363730"
"012610","경인양행","5460","6030","570","10.44","2967932","17155630540"
"009140","경인전자","25500","27850","2350","9.22","74440","1962484450"
"024910","경창산업","2430","2605","175","7.20","1051602","2655813945"
"013580","계룡건설","25000","26100","1100","4.40","950898","23015216550"
"012200","계양전기","3060","3295","235","7.68","4623446","15172478840"
"012205","계양전기우","6670","5870","-800","-11.99","429388","2710152430"
"002140","고려산업","7070","4900","-2170","-30.69","29959201","180828275020"
"198440","고려시멘트","3450","3720","270","7.83","30122411","112822843000"
"049720","고려신용정보","11600","10550","-1050","-9.05","18611336","222115159350"
"010130","고려아연","463000","583000","120000","25.92","1107079","553300366000"
"002240","고려제강","20400","21600","1200","5.88","627347","12872840250"
"014570","고려제약","7700","8150","450","5.84","633491","5086702480"
"348150","고바이오랩","12750","14000","1250","9.80","744153","10184471800"
"098460","고영","13450","14700","1250","9.29","4806513","66674829955"
"035290","골드앤에스","2410","2440","30","1.24","9282476","24467195080"
"038530","골드퍼시픽","674","664","-10","-1.48","49891116","38836502327"
"900280","골든센츄리","371","383","12","3.23","35594542","14214854264"
"215000","골프존","139900","138700","-1200","-0.86","970804","135725311700"
"121440","골프존뉴딘홀딩스","7050","6930","-120","-1.70","883016","6024860490"
"183410","골프존데카","4390","4480","90","2.05","14412","61098520"
"366030","공구우먼","31600","11350","-20250","-64.08","34575891","514002932550"
"076340","관악산업","6700","6990","290","4.33","31564","165029030"
"009290","광동제약","6390","6710","320","5.01","8291274","57374778980"
"014200","광림","1490","1435","-55","-3.69","28614746","41103489275"
"017040","광명전기","3170","2925","-245","-7.73","19539758","58713519615"
"029480","광무","2855","3675","820","28.72","3797080","13965581355"
"017900","광전자","2260","2455","195","8.63","1608020","3769169895"
"037710","광주신세계","33300","33600","300","0.90","107944","3556581800"
"026910","광진실업","4895","5820","925","18.90","1254617","7077587745"
"355150","교보10호스팩","2240","2240","0","0.00","245621","549751790"
"397880","교보11호스팩","2145","2130","-15","-0.70","324126","696562715"
"421800","교보12호스팩","2105","2100","-5","-0.24","454235","961923375"
"331520","교보9호스팩","2470","2275","-195","-7.89","23912277","60256676835"
"030610","교보증권","6350","6440","90","1.42","727885","4553259380"
"339770","교촌에프앤비","11800","12200","400","3.39","750580","8915861150"
"053270","구영테크","3275","3370","95","2.90","17944351","61373787635"
"007690","국도화학","48850","51600","2750","5.63","549037","27085107150"
"005320","국동","1785","1805","20","1.12","27884154","55439830365"
"001140","국보","1190","1075","-115","-9.66","21098816","23739396470"
"066620","국보디자인","17000","17750","750","4.41","400142","6956136750"
"043650","국순당","8830","9380","550","6.23","1320209","11977358430"
"006050","국영지앤엠","1530","1635","105","6.86","10969968","18338614030"
"060480","국일신동","2970","3685","715","24.07","16485616","65045261070"
"078130","국일제지","2615","2715","100","3.82","9150534","23877066305"
"307750","국전약품","7380","8080","700","9.49","71978811","659738541550"
"002720","국제약품","5770","5590","-180","-3.12","11426669","67000875480"
"243870","굿센","15000","15500","500","3.33","2899","45532350"
"035080","그래디언트","18000","19450","1450","8.06","1635190","29999822900"
"204020","그리티","3145","3325","180","5.72","5766438","19030974615"
"083420","그린케미칼","7080","8990","1910","26.98","24553315","220238692080"
"186230","그린플러스","12000","13450","1450","12.08","881775","11185904200"
"014530","극동유화","3615","3765","150","4.15","2449343","8926100405"
"900070","글로벌에스엠","800","776","-24","-3.00","8043127","6391446324"
"204620","글로벌텍스프리","2475","2465","-10","-0.40","4773633","12487053520"
"019660","글로본","2490","2935","445","17.87","6085507","16541702145"
"014280","금강공업","7140","7450","310","4.34","2077632","14633698850"
"014285","금강공업우","12900","13050","150","1.16","26208","334139250"
"053260","금강철강","7120","7060","-60","-0.84","1955131","13504963560"
"008870","금비","71100","70600","-500","-0.70","49923","3735718400"
"001570","금양","5200","10400","5200","100.00","281147215","2427470150090"
"002990","금호건설","8010","8790","780","9.74","1224371","10053424220"
"002995","금호건설우","26550","28800","2250","8.47","6268","168280900"
"011780","금호석유","138000","133500","-4500","-3.26","2369730","298563419500"
"011785","금호석유우","87600","90300","2700","3.08","201183","17019656400"
"214330","금호에이치티","1290","1220","-70","-5.43","26641631","34386003250"
"001210","금호전기","1400","1410","10","0.71","4294840","5890739210"
"073240","금호타이어","3475","3735","260","7.48","5426448","19171814935"
"036190","금화피에스시","29850","30200","350","1.17","54317","1599897800"
"049080","기가레인","1525","1610","85","5.57","10955073","17293415840"
"035460","기산텔레콤","3425","4060","635","18.54","31585460","117726986620"
"092440","기신정기","3485","3750","265","7.60","371110","1336421580"
"000270","기아","76800","80700","3900","5.08","28760016","2322711790256"
"024110","기업은행","9210","9580","370","4.02","20129617","186541280050"
"013700","까뮤이앤씨","1910","2400","490","25.65","74206160","170677116605"
"308100","까스텔바작","9980","11200","1220","12.22","18339506","192583757280"
"004540","깨끗한나라","3505","3685","180","5.14","3467086","12743972400"
"004545","깨끗한나라우","19300","20050","750","3.89","7263","139719400"
"187790","나노","1095","1205","110","10.05","2418833","2813876900"
"286750","나노브릭","2065","2320","255","12.35","5609722","12821932600"
"121600","나노신소재","72100","89000","16900","23.44","4271167","342747066600"
"247660","나노씨엠에스","34500","31000","-3500","-10.14","4702196","165443674350"
"039860","나노엔텍","5440","5600","160","2.94","20760954","129334699990"
"091970","나노캠텍","1610","1610","0","0.00","0","0"
"244880","나눔테크","3035","3075","40","1.32","1345","3987535"
"288490","나라소프트","145","125","-20","-13.79","273396","34617861"
"051490","나라엠앤디","6420","7420","1000","15.58","5640202","40248362990"
"137080","나래나노텍","9110","9070","-40","-0.44","4409711","42233358070"
"190510","나무가","9430","10200","770","8.17","3544515","35822134940"
"242040","나무기술","1790","2055","265","14.80","21810147","47031308000"
"089600","나스미디어","22800","25750","2950","12.94","454331","11127570450"
"293580","나우IB","8550","8610","60","0.70","1359664","12256521130"
"257990","나우코스","5880","7100","1220","20.75","21210","137083670"
"138610","나이벡","24000","24100","100","0.42","1063666","26209406300"
"130580","나이스디앤비","7310","7900","590","8.07","788935","6709651190"
"036800","나이스정보통신","25200","25800","600","2.38","686712","17829951850"
"267320","나인테크","3605","4015","410","11.37","46470322","179535145965"
"001260","남광토건","11350","11550","200","1.76","2038240","22444531690"
"008350","남선알미늄","2130","2265","135","6.34","62396982","141367945235"
"008355","남선알미우","22050","23800","1750","7.94","81168","1903588500"
"004270","남성","2260","2450","190","8.41","2522743","6133240255"
"003920","남양유업","369500","385000","15500","4.19","12558","4659062000"
"003925","남양유업우","199500","213000","13500","6.77","2112","430134000"
"025860","남해화학","9650","10050","400","4.15","9836682","94970702150"
"111710","남화산업","7450","8080","630","8.46","190807","1453509020"
"091590","남화토건","7480","7880","400","5.35","1511158","11940714040"
"168330","내츄럴엔도텍","4265","4890","625","14.65","1047571","5102284775"
"094860","네오리진","717","737","20","2.79","22114479","17339353382"
"253590","네오셈","3430","3325","-105","-3.06","3529060","12067893520"
"212560","네오오토","6050","7520","1470","24.30","6221853","46416036300"
"095660","네오위즈","25900","27950","2050","7.92","7597603","209531864200"
"042420","네오위즈홀딩스","29450","32750","3300","11.21","2312144","74408100100"
"950220","네오이뮨텍","4520","5200","680","15.04","58785958","301735408740"
"311390","네오크레마","13800","14000","200","1.45","1849367","28309578600"
"085910","네오티스","5010","5470","460","9.18","1774339","9226695115"
"092730","네오팜","20150","20350","200","0.99","233016","4769671600"
"290660","네오펙트","2095","2195","100","4.77","1755104","3966931650"
"306620","네온테크","4405","4505","100","2.27","41365972","191509484220"
"153460","네이블","7180","7380","200","2.79","193124","1447918750"
"007390","네이처셀","18950","23250","4300","22.69","23821229","548828506900"
"033640","네패스","19250","20350","1100","5.71","2400871","46804330950"
"330860","네패스아크","28550","29150","600","2.10","845996","24085706900"
"005720","넥센","3470","3640","170","4.90","258267","916621880"
"005725","넥센우","3085","3030","-55","-1.78","88164","257116610"
"002350","넥센타이어","5520","6530","1010","18.30","3025599","18794577840"
"002355","넥센타이어1우B","2745","2930","185","6.74","392759","1075580200"
"089140","넥스턴바이오","2785","3360","575","20.65","57040723","194473110720"
"137940","넥스트아이","720","742","22","3.06","5222073","3947944145"
"396270","넥스트칩","14700","10950","-3750","-25.51","16799017","216878963000"
"348210","넥스틴","59000","56000","-3000","-5.08","1412824","85657739600"
"225570","넥슨게임즈","17450","22400","4950","28.37","21007761","435168902700"
"217270","넵튠","11650","15000","3350","28.76","7422206","115067779700"
"251270","넷마블","68700","72300","3600","5.24","4586018","322391856200"
"317860","노드메이슨","7300","8490","1190","16.30","2084","15469890"
"104620","노랑풍선","8230","7750","-480","-5.83","1262628","9538569030"
"090350","노루페인트","8360","9850","1490","17.82","5074769","47502994810"
"090355","노루페인트우","15000","17400","2400","16.00","27114","436854350"
"000320","노루홀딩스","10750","11650","900","8.37","253811","2885657700"
"000325","노루홀딩스우","25500","21500","-4000","-15.69","99935","2213232800"
"194700","노바렉스","29100","32600","3500","12.03","438434","13750208350"
"285490","노바텍","31850","32700","850","2.67","1089993","36703969150"
"229500","노브메타파마","12500","13350","850","6.80","31085","388559850"
"106520","노블엠앤비","3625","4000","375","10.34","6545205","25472758140"
"376930","노을","9230","7410","-1820","-19.72","6222325","49611167630"
"278650","노터스","8250","6780","-1470","-17.82","110938798","826980310030"
"006280","녹십자","177000","172500","-4500","-2.54","697377","123662941500"
"142280","녹십자엠에스","7760","7820","60","0.77","23960449","202186307830"
"234690","녹십자웰빙","8010","8150","140","1.75","1132912","9312871620"
"005250","녹십자홀딩스","19950","20650","700","3.51","2036682","42575941350"
"005257","녹십자홀딩스2우","56500","56400","-100","-0.18","130602","8080284400"
"065560","녹원씨엔아이","5770","5770","0","0.00","0","0"
"004370","농심","283000","296500","13500","4.77","472271","134365686000"
"072710","농심홀딩스","68400","68300","-100","-0.15","46112","3111854700"
"054050","농우바이오","9850","10150","300","3.05","632302","6338540400"
"069140","누리플랜","5840","5730","-110","-1.88","435481","2488683450"
"040160","누리플렉스","6840","6410","-430","-6.29","3333567","22767354950"
"332290","누보","2795","2315","-480","-17.17","13008720","31915049300"
"126870","뉴로스","2230","2230","0","0.00","0","0"
"060260","뉴보텍","1120","1320","200","17.86","52204146","65464773490"
"012340","뉴인텍","2970","4010","1040","35.02","81543372","322582058220"
"214870","뉴지랩파마","9080","13950","4870","53.63","9685634","111927357980"
"270870","뉴트리","13100","13500","400","3.05","964685","12444762000"
"144960","뉴파워프라즈마","4060","4570","510","12.56","1796227","8151402930"
"085670","뉴프렉스","4305","5170","865","20.09","10820807","53175437700"
"119860","다나와","17350","18900","1550","8.93","493260","8932341800"
"064260","다날","7170","7710","540","7.53","40908160","309386566000"
"093640","다믈멀티미디어","3720","4235","515","13.84","957192","3938842450"
"340360","다보링크","1235","1365","130","10.53","3738041","4807366905"
"039560","다산네트웍스","5670","5930","260","4.59","1079672","6258894590"
"058730","다스코","5500","6190","690","12.55","23823541","133588232365"
"298870","다올인베스트먼트","3180","3315","135","4.25","14643106","50951135260"
"030210","다올투자증권","4285","4455","170","3.97","2198563","9546717465"
"023590","다우기술","17800","18900","1100","6.18","711079","13087245700"
"032190","다우데이타","10250","11700","1450","14.15","1373661","14859670960"
"323350","다원넥스뷰","54000","47000","-7000","-12.96","1057","53901900"
"068240","다원시스","22550","23800","1250","5.54","3509774","79088956050"
"145210","다이나믹디자인","4735","4630","-105","-2.22","204034","945653725"
"271850","다이오진","1690","1690","0","0.00","0","0"
"019680","대교","2920","3050","130","4.45","1320332","4039861690"
"019685","대교우B","2175","2270","95","4.37","420170","994052720"
"006370","대구백화점","11250","10650","-600","-5.33","59458","638450400"
"008060","대덕","6220","6670","450","7.23","1251303","8189974440"
"00806K","대덕1우","9200","9200","0","0.00","34614","318631790"
"353200","대덕전자","28150","27350","-800","-2.84","15093663","432539331300"
"35320K","대덕전자1우","12300","12350","50","0.41","114445","1426600000"
"000490","대동","11450","12150","700","6.11","6926206","83603281950"
"178600","대동고려삼","4200","3840","-360","-8.57","25270","89541175"
"020400","대동금속","9060","10250","1190","13.13","2950762","30173048390"
"008830","대동기어","7200","8240","1040","14.44","17437062","151173453760"
"048470","대동스틸","4980","5710","730","14.66","9644308","56277081635"
"008110","대동전자","6450","13600","7150","110.85","51542592","568703405850"
"004780","대륙제관","4615","4820","205","4.44","7702212","38694834730"
"005750","대림B&Co","5000","6170","1170","23.40","5480505","33177544265"
"017650","대림제지","8640","8960","320","3.70","276247","2451139880"
"006570","대림통상","3895","3915","20","0.51","297086","1077620585"
"007720","대명소노시즌","852","900","48","5.63","3736472","3230607874"
"389260","대명에너지","14700","23900","9200","62.59","23335371","453704312650"
"317850","대모","8330","8030","-300","-3.60","6631478","53462702350"
"290670","대보마그네틱","41350","48150","6800","16.44","1165217","53456164750"
"078140","대봉엘에스","7420","8400","980","13.21","16291909","152095186560"
"001680","대상","21400","23750","2350","10.98","2721542","60979108800"
"001685","대상우","16050","17050","1000","6.23","96478","1577429350"
"084690","대상홀딩스","7990","8790","800","10.01","1031730","8570307910"
"084695","대상홀딩스우","10000","10400","400","4.00","306857","3157409290"
"036480","대성미생물","12300","13000","700","5.69","153926","1940278500"
"128820","대성산업","5110","5100","-10","-0.20","10570323","53358247725"
"117580","대성에너지","10750","13850","3100","28.84","30064498","378484489900"
"025440","대성엘텍","884","931","47","5.32","25440076","22782794664"
"027830","대성창투","3000","3455","455","15.17","152580608","652276389875"
"104040","대성파인텍","1625","1965","340","20.92","44259835","89581585105"
"016710","대성홀딩스","75500","85900","10400","13.77","2805103","228805339900"
"387310","대신밸런스제10호스팩","2265","2320","55","2.43","367728","834898060"
"397500","대신밸런스제11호스팩","2680","2680","0","0.00","0","0"
"020180","대신정보통신","1150","1375","225","19.57","42018567","58112785820"
"003540","대신증권","14900","15300","400","2.68","842236","12638485100"
"003547","대신증권2우B","13300","13750","450","3.38","268011","3573466100"
"003545","대신증권우","13550","14250","700","5.17","838156","11545642800"
"045390","대아티아이","3385","3710","325","9.60","23056619","84711586420"
"009190","대양금속","3560","3960","400","11.24","10231061","39395364505"
"108380","대양전기공업","12300","13450","1150","9.35","573444","7071252650"
"006580","대양제지","3260","3260","0","0.00","0","0"
"014160","대영포장","1650","1785","135","8.18","22506960","40607750315"
"047040","대우건설","5640","5490","-150","-2.66","42282520","224332697160"
"009320","대우부품","1810","2160","350","19.34","8234789","17981815435"
"042660","대우조선해양","20400","21600","1200","5.88","10770454","216575317350"
"003090","대웅","27250","27200","-50","-0.18","752207","21066539950"
"069620","대웅제약","179500","179500","0","0.00","1127139","206931936500"
"007680","대원","8840","8900","60","0.68","311867","2706080730"
"000430","대원강업","2825","3180","355","12.57","5236628","17816668535"
"048910","대원미디어","12350","14700","2350","19.03","2258462","31184749850"
"005710","대원산업","5280","5460","180","3.41","253899","1350256970"
"006340","대원전선","1500","1570","70","4.67","7398373","11221973515"
"006345","대원전선우","2630","2795","165","6.27","102176","268669250"
"003220","대원제약","17500","18150","650","3.71","9846638","182873978350"
"024890","대원화성","2450","3240","790","32.24","73532920","237630529530"
"290380","대유","4495","4640","145","3.23","16469612","79379832830"
"002880","대유에이텍","841","890","49","5.83","6327374","5428449763"
"290120","대유에이피","5470","6310","840","15.36","898268","5426720130"
"000300","대유플러스","869","946","77","8.86","9296166","8497026125"
"120240","대정화금","18100","18650","550","3.04","1080729","20047569750"
"003310","대주산업","3310","2645","-665","-20.09","35140110","102341027455"
"114920","대주이엔티","1820","2390","570","31.32","1535","2711950"
"078600","대주전자재료","65600","87500","21900","33.38","4340389","332257250300"
"012800","대창","1400","1535","135","9.64","7215403","10425470225"
"015230","대창단조","5240","5470","230","4.39","3901542","19906292795"
"096350","대창솔루션","433","423","-10","-2.31","19517262","8220577854"
"140520","대창스틸","3270","3470","200","6.12","1225137","4071569625"
"131220","대한과학","7400","10100","2700","36.49","25721516","264163805210"
"010170","대한광통신","2200","3240","1040","47.27","30124143","84451996405"
"060900","대한그린파워","735","874","139","18.91","71752298","59674474150"
"054670","대한뉴팜","10200","10750","550","5.39","1277067","13338778670"
"001070","대한방직","49700","52600","2900","5.84","471738","23054163700"
"023910","대한약품","26100","27000","900","3.45","97153","2618395200"
"006650","대한유화","128500","130000","1500","1.17","710171","88460561000"
"001440","대한전선","1825","1845","20","1.10","223531313","386398835665"
"084010","대한제강","15300","16550","1250","8.17","988556","15531056450"
"001790","대한제당","3300","3005","-295","-8.94","16856033","52961236280"
"001795","대한제당우","3215","2910","-305","-9.49","4571761","14274055510"
"001130","대한제분","145000","142500","-2500","-1.72","70727","9865166500"
"003490","대한항공","25150","25900","750","2.98","30890280","777322973250"
"003495","대한항공우","33350","32550","-800","-2.40","104671","3476199350"
"005880","대한해운","2440","2500","60","2.46","19347922","45833153060"
"003830","대한화섬","106000","110500","4500","4.25","11999","1256640000"
"016090","대현","2100","2250","150","7.14","3650117","7766850730"
"069460","대호에이엘","2500","2140","-360","-14.40","60795336","135381793885"
"021040","대호특수강","632","743","111","17.56","1874220","1298631856"
"021045","대호특수강우","1320","1320","0","0.00","177731","237663400"
"067080","대화제약","7150","8110","960","13.43","842795","6388247210"
"298540","더네이쳐홀딩스","29600","28950","-650","-2.20","584579","17283627000"
"192080","더블유게임즈","40900","40050","-850","-2.08","1194597","48605637600"
"299170","더블유에스아이","2040","2360","320","15.69","1229582","2717890910"
"012510","더존비즈온","36100","33150","-2950","-8.17","2354280","79002243550"
"302920","더콘텐츠온","9990","9990","0","0.00","72","684530"
"213420","덕산네오룩스","31200","31450","250","0.80","1986469","62869915250"
"317330","덕산테코피아","15650","16000","350","2.24","1068500","16788341400"
"077360","덕산하이메탈","7280","7080","-200","-2.75","5371237","40215805150"
"004830","덕성","6260","6220","-40","-0.64","2406490","15129569390"
"004835","덕성우","7260","7250","-10","-0.14","245713","1806149190"
"090410","덕신하우징","2240","2500","260","11.61","40016237","93406077095"
"024900","덕양산업","2480","2780","300","12.10","1432855","3813256620"
"263600","덕우전자","6270","7320","1050","16.75","11181174","82451640800"
"194480","데브시스터즈","45000","45600","600","1.33","3092809","149350657100"
"348840","데이드림엔터","10950","10500","-450","-4.11","0","0"
"263800","데이타솔루션","5490","5650","160","2.91","4508276","25066166480"
"199150","데이터스트림즈","11450","10250","-1200","-10.48","6231","62688350"
"206560","덱스터","14150","16400","2250","15.90","17539315","280561964650"
"261200","덴티스","8840","10050","1210","13.69","2155097","20464970640"
"145720","덴티움","84200","101500","17300","20.55","3384757","292338106700"
"227420","도부마스크","4080","3840","-240","-5.88","152444","570933720"
"067990","도이치모터스","8380","8240","-140","-1.67","7154161","59489502270"
"002150","도화엔지니어링","9450","9290","-160","-1.69","10179062","93747900580"
"006620","동구바이오제약","6520","6850","330","5.06","2025597","13742411430"
"100130","동국S&C","5530","7110","1580","28.57","58913164","398467816270"
"005160","동국산업","2855","3070","215","7.53","1156794","3382685560"
"075970","동국알앤에스","3790","4195","405","10.69","17257011","72919502295"
"001230","동국제강","12750","14000","1250","9.80","9164879","117820588700"
"086450","동국제약","19850","19700","-150","-0.76","1226241","23801674650"
"023450","동남합성","58400","59000","600","1.03","18820","1096216400"
"004140","동방","2780","2970","190","6.83","4974998","14537674395"
"099410","동방선기","3125","3460","335","10.72","2288937","7450450635"
"007590","동방아그로","6900","7250","350","5.07","267167","1876641500"
"005960","동부건설","10850","11800","950","8.76","799165","8644243500"
"005965","동부건설우","25700","28500","2800","10.89","8760","225298950"
"026960","동서","25700","25450","-250","-0.97","1075062","26878395300"
"002210","동성제약","7860","8060","200","2.54","654705","5172460310"
"102260","동성케미컬","4000","4460","460","11.50","626362","2659500475"
"033500","동성화인텍","10750","12400","1650","15.35","7423885","86453264800"
"025950","동신건설","20250","22550","2300","11.36","2677564","58560157650"
"000640","동아쏘시오홀딩스","102500","108500","6000","5.85","166234","17306448000"
"170900","동아에스티","58900","59600","700","1.19","113137","6905860900"
"088130","동아엘텍","7020","7420","400","5.70","197051","1416567020"
"028100","동아지질","16650","18650","2000","12.01","1042788","18480287300"
"282690","동아타이어","11600","12050","450","3.88","150735","1762338100"
"041930","동아화성","8060","9210","1150","14.27","2686107","23569090980"
"001520","동양","1150","1195","45","3.91","6659925","7811491505"
"001527","동양2우B","12400","13050","650","5.24","27131","343917250"
"084670","동양고속","15700","16600","900","5.73","16822","264728000"
"082640","동양생명","5600","5500","-100","-1.79","1566580","8507100880"
"060380","동양에스텍","2435","2760","325","13.35","13176281","36666627630"
"001525","동양우","6300","6340","40","0.63","51081","322064030"
"079960","동양이엔피","13600","14900","1300","9.56","459570","6586431650"
"008970","동양철관","1085","1165","80","7.37","34090046","38132082165"
"228340","동양파일","3625","3910","285","7.86","783079","2887603840"
"092780","동양피스톤","4880","5300","420","8.61","996432","5017724960"
"088910","동우팜투테이블","2765","2935","170","6.15","2355870","6542214270"
"094170","동운아나텍","8490","8350","-140","-1.65","9441335","81968541320"
"049770","동원F&B","153500","165000","11500","7.49","62687","9867153000"
"013120","동원개발","4200","4205","5","0.12","2105517","8751567745"
"018500","동원금속","864","904","40","4.63","1782095","1582455294"
"006040","동원산업","214000","230000","16000","7.48","57566","12866717500"
"030720","동원수산","9250","10050","800","8.65","1796471","17822265560"
"014820","동원시스템즈","51900","57900","6000","11.56","642179","35457679050"
"014825","동원시스템즈우","31750","34150","2400","7.56","2681","87377700"
"163560","동일고무벨트","7930","7180","-750","-9.46","1993556","14544946100"
"109860","동일금속","18200","20150","1950","10.71","1213035","22876171400"
"032960","동일기연","11700","13250","1550","13.25","5040366","70970810800"
"004890","동일산업","169000","180000","11000","6.51","93190","16276826500"
"002690","동일제강","3245","3380","135","4.16","2526428","8156687960"
"023790","동일철강","2705","2790","85","3.14","687947","1850846870"
"005290","동진쎄미켐","33450","34250","800","2.39","15863264","557225469100"
"025900","동화기업","60900","73600","12700","20.85","1121828","73511647700"
"000020","동화약품","10500","10550","50","0.48","3305030","35912448250"
"000150","두산","68100","80500","12400","18.21","1646528","116715072400"
"000157","두산2우B","93500","101500","8000","8.56","33016","3165663400"
"241560","두산밥캣","29100","32550","3450","11.86","6484364","199705800800"
"034020","두산에너빌리티","18550","20300","1750","9.43","79188185","1466998498950"
"000155","두산우","45600","52200","6600","14.47","55539","2635872800"
"131970","두산테스나","30750","29250","-1500","-4.88","2948739","87334702150"
"336260","두산퓨얼셀","30000","38750","8750","29.17","8573764","280709381600"
"33626K","두산퓨얼셀1우","9460","13500","4040","42.71","1021106","12411579970"
"33626L","두산퓨얼셀2우B","12450","16100","3650","29.32","613461","9132170150"
"016740","두올","2760","2965","205","7.43","2450741","7114406410"
"073190","듀오백","2215","2770","555","25.06","1070122","2756531905"
"176750","듀켐바이오","7030","6700","-330","-4.69","136105","914238250"
"030350","드래곤플라이","1885","2090","205","10.88","29691516","61297510430"
"203650","드림시큐리티","3110","3375","265","8.52","11672184","39375495710"
"223250","드림씨아이에스","14050","14300","250","1.78","751783","10608319450"
"060570","드림어스컴퍼니","3300","3695","395","11.97","1029437","3564211290"
"192650","드림텍","9570","9260","-310","-3.24","3612679","33571713410"
"217620","디딤","1375","1400","25","1.82","8853610","13029702117"
"016670","디모아","973","973","0","0.00","0","0"
"187870","디바이스이엔지","17200","18300","1100","6.40","219095","3968292650"
"066670","디스플레이텍","5950","6180","230","3.87","6390056","40654199260"
"024090","디씨엠","22350","20550","-1800","-8.05","1069625","22787799050"
"003160","디아이","5910","6180","270","4.57","1594425","10011776990"
"092200","디아이씨","4125","4480","355","8.61","2532942","10935244420"
"110990","디아이티","7170","7100","-70","-0.98","1599913","11960159860"
"078590","디아크","2380","2380","0","0.00","0","0"
"263690","디알젬","8710","9640","930","10.68","176455","1648402750"
"214680","디알텍","1525","1640","115","7.54","9195293","14223344010"
"377190","디앤디플랫폼리츠","4410","4650","240","5.44","2763134","11911025545"
"263720","디앤씨미디어","21700","22900","1200","5.53","956324","22095815050"
"376300","디어유","34750","37400","2650","7.63","3722569","140618143150"
"141020","디에스앤엘","1335","1335","0","0.00","0","0"
"109740","디에스케이","5190","5770","580","11.18","344086","1906380140"
"196490","디에이테크놀로지","3930","4720","790","20.10","4514414","19114742075"
"066900","디에이피","3310","3495","185","5.59","867161","2988547790"
"180400","디엑스앤브이엑스","7740","7740","0","0.00","0","0"
"127120","디엔에이링크","3975","3895","-80","-2.01","1542021","5937458905"
"092070","디엔에프","14550","14050","-500","-3.44","1074565","15826376450"
"039840","디오","26700","27700","1000","3.75","1040800","28253579800"
"013570","디와이","6850","7350","500","7.30","6524746","46374399520"
"219550","디와이디","1435","1540","105","7.32","25547870","39173222365"
"310870","디와이씨","1450","1595","145","10.00","3861356","5962139105"
"210540","디와이파워","12650","12550","-100","-0.79","1319488","15649816150"
"104460","디와이피엔에프","38500","40500","2000","5.19","477788","18269631250"
"079810","디이엔티","6780","7950","1170","17.26","1361287","10180235660"
"113810","디젠스","1100","1240","140","12.73","34814590","45086881939"
"043360","디지아이","3600","3445","-155","-4.31","1401500","4982105315"
"197140","디지캡","4045","4130","85","2.10","1245882","4966131745"
"068930","디지털대성","6940","7920","980","14.12","894300","6456799870"
"033130","디지틀조선","2180","2325","145","6.65","1972762","4459958035"
"105740","디케이락","9440","12000","2560","27.12","1462636","15489617800"
"263020","디케이앤디","2955","3165","210","7.11","1022908","3154515420"
"290550","디케이티","9240","10950","1710","18.51","1741286","18321522800"
"187220","디티앤씨","5040","5620","580","11.51","2358868","13123545790"
"163430","디피코","7620","7620","0","0.00","0","0"
"131180","딜리","1660","1675","15","0.90","1368010","2248982715"
"315640","딥노이드","8180","8670","490","5.99","1263347","11181222870"
"317120","라닉스","6200","6760","560","9.03","1457187","9689369300"
"042510","라온시큐어","2745","3050","305","11.11","11330701","33685922000"
"232680","라온테크","14700","14650","-50","-0.34","2557282","37692397400"
"300120","라온피플","7132","5780","-1352","-18.96","7012592","65867532800"
"171120","라이온켐텍","7600","8950","1350","17.76","11297979","105126722830"
"069540","라이트론","3880","4250","370","9.54","1663080","6568464825"
"285770","라이프사이언스테크놀로지","1390","1390","0","0.00","0","0"
"347700","라이프시맨틱스","5700","5950","250","4.39","2178336","13212238650"
"214260","라파스","38600","40500","1900","4.92","613617","24835434800"
"403360","라피치","13000","13500","500","3.85","1488","18975600"
"115390","락앤락","7810","8070","260","3.33","4575713","39971269900"
"200350","래몽래인","16100","21800","5700","35.40","4560752","89505921650"
"171010","램테크놀러지","6190","7430","1240","20.03","5717471","40662011430"
"084650","랩지노믹스","7590","8100","510","6.72","93329615","824652284250"
"217500","러셀","3490","3820","330","9.46","10681024","40842461455"
"092590","럭스피아","2350","2085","-265","-11.28","25943","48196140"
"141080","레고켐바이오","47950","50200","2250","4.69","5251845","245398339650"
"060300","레드로버","1830","1830","0","0.00","0","0"
"038390","레드캡투어","18350","20250","1900","10.35","434760","8858410700"
"294140","레몬","5920","5420","-500","-8.45","12067029","68683354400"
"228670","레이","23950","23150","-800","-3.34","2947570","71095512500"
"228850","레이언스","9500","10700","1200","12.63","960507","10044583490"
"412350","레이저쎌","14750","12250","-2500","-16.95","11641547","150104099390"
"281740","레이크머티리얼즈","4450","4715","265","5.96","9310464","44928536320"
"277810","레인보우로보틱스","23750","28100","4350","18.32","10600212","295707532950"
"179720","렌딩머신","5600","5100","-500","-8.93","165","967400"
"215100","로보로보","7300","7750","450","6.16","19358395","150170275100"
"090360","로보스타","18500","20650","2150","11.62","2214746","44143190700"
"238500","로보쓰리","798","720","-78","-9.77","971143","687361240"
"108490","로보티즈","18150","21700","3550","19.56","8743333","186808783800"
"900260","로스웰","307","360","53","17.26","213172899","78832640434"
"223220","로지스몬","598","590","-8","-1.34","3159","1509486"
"067730","로지시스","4950","5840","890","17.98","6694592","40643401500"
"071280","로체시스템즈","6020","6380","360","5.98","2324843","14541147970"
"032350","롯데관광개발","11900","11850","-50","-0.42","8647129","98351221200"
"089860","롯데렌탈","36650","38150","1500","4.09","1520175","58438427650"
"330590","롯데리츠","5290","5080","-210","-3.97","5505885","27834659433"
"000400","롯데손해보험","1615","1705","90","5.57","3675025","6146674330"
"023530","롯데쇼핑","99000","102000","3000","3.03","2142156","202247199400"
"004000","롯데정밀화학","68800","68400","-400","-0.58","3402953","223771112700"
"286940","롯데정보통신","26350","27550","1200","4.55","552857","14917545750"
"280360","롯데제과","115500","123000","7500","6.49","247820","29279876500"
"004990","롯데지주","35050","38850","3800","10.84","3799228","136191245200"
"00499K","롯데지주우","47600","50700","3100","6.51","20902","1014178100"
"005300","롯데칠성","174000","166500","-7500","-4.31","893528","151793042500"
"005305","롯데칠성우","71900","71400","-500","-0.70","25641","1823865900"
"011170","롯데케미칼","180000","183000","3000","1.67","2372056","411715670000"
"071840","롯데하이마트","16850","16750","-100","-0.59","411632","6946797550"
"038060","루멘스","1135","1190","55","4.85","3334361","3896154270"
"162120","루켄테크놀러지스","4800","5100","300","6.25","42518","203993190"
"253610","루트락","2395","2290","-105","-4.38","20701","42295815"
"085370","루트로닉","17900","20700","2800","15.64","7331960","140319283900"
"08537M","루트로닉3우C","25200","28850","3650","14.48","4168","107938600"
"060240","룽투코리아","4765","5280","515","10.81","32335360","173636140285"
"058470","리노공업","134200","131800","-2400","-1.79","1015933","133271059464"
"039980","리노스","1030","973","-57","-5.53","7483680","7114505490"
"019570","리더스 기술투자","400","388","-12","-3.00","12885616","5100722038"
"016100","리더스코스메틱","2820","2630","-190","-6.74","346680","933920380"
"012700","리드코프","8080","8420","340","4.21","2699400","22423612680"
"302550","리메드","13400","13550","150","1.12","458887","6406228200"
"377450","리파인","11500","11050","-450","-3.91","855094","9477654900"
"277070","린드먼아시아","4720","5050","330","6.99","4352290","22642448515"
"042500","링네트","4550","5020","470","10.33","5081541","27520649295"
"219420","링크제니시스","5680","7040","1360","23.94","9645719","68445246240"
"027740","마니커","1585","1415","-170","-10.73","10177113","14585654345"
"195500","마니커에프앤지","3915","4100","185","4.73","4040167","16585049455"
"357430","마스턴프리미어리츠","5010","5010","0","0.00","336264","1664690370"
"222810","마이더스AI","2070","1565","-505","-24.40","58928968","118538694385"
"305090","마이크로디지탈","5140","5350","210","4.09","1653717","9498102520"
"098120","마이크로컨텍솔","6300","6430","130","2.06","1262430","8135648490"
"147760","마이크로프랜드","4550","4935","385","8.46","396340","1935876805"
"377480","마인즈랩","16250","16950","700","4.31","1448010","24412046200"
"038290","마크로젠","26200","26850","650","2.48","318032","8344388000"
"204320","만도","48500","56200","7700","15.88","7269109","393528102100"
"001080","만호제강","22300","27600","5300","23.77","198510","4821760050"
"267980","매일유업","59100","59200","100","0.17","230183","13478052700"
"005990","매일홀딩스","9230","8900","-330","-3.58","102382","918807740"
"127160","매직마이크로","282","282","0","0.00","0","0"
"093520","매커스","7940","9000","1060","13.35","3225864","28369534620"
"377030","맥스트","17850","18850","1000","5.60","11709218","218431153200"
"088980","맥쿼리인프라","12200","12900","700","5.74","20352318","252843725750"
"094800","맵스리얼티1","4520","4510","-10","-0.22","796840","3536004420"
"100590","머큐리","6430","6690","260","4.04","379950","2493521480"
"067280","멀티캠퍼스","38100","40100","2000","5.25","161575","6539952300"
"072870","메가스터디","11200","11300","100","0.89","1499800","17354780550"
"215200","메가스터디교육","77400","85000","7600","9.82","1478858","126956957300"
"133750","메가엠디","2670","3130","460","17.23","57506877","210456641795"
"235980","메드팩토","26400","32500","6100","23.11","5295070","160486239500"
"200580","메디쎄이","14000","16400","2400","17.14","82731","1189713100"
"041920","메디아나","5100","5050","-50","-0.98","12369305","68722196395"
"233250","메디안디노스틱","32600","32700","100","0.31","267","8364050"
"014100","메디앙스","4160","4085","-75","-1.80","561506","2266702940"
"236340","메디젠휴먼케어","9400","9080","-320","-3.40","4828","43737760"
"054180","메디콕스","5410","8250","2840","52.50","16403983","124491802410"
"086900","메디톡스","113800","110000","-3800","-3.34","477774","54114400200"
"078160","메디포스트","19450","21300","1850","9.51","3567846","76622757300"
"065650","메디프론","1595","1715","120","7.52","2100104","3565459745"
"138040","메리츠금융지주","26600","29200","2600","9.77","3001353","78279584300"
"008560","메리츠증권","4665","4875","210","4.50","16069692","74375781210"
"000060","메리츠화재","32550","37250","4700","14.44","3583983","120586151350"
"021880","메이슨캐피탈","566","475","-91","-16.08","28394611","14286191941"
"140410","메지온","19600","18650","-950","-4.85","10107527","212789643800"
"241770","메카로","10550","11550","1000","9.48","193963","2097387510"
"090370","메타랩스","871","730","-141","-16.19","9090672","6982407462"
"059210","메타바이오메드","2270","2450","180","7.93","2209507","5281774870"
"058110","멕아이씨에스","6090","6390","300","4.93","29567786","211547992170"
"096640","멜파스","1495","1495","0","0.00","0","0"
"017180","명문제약","3270","3475","205","6.27","1303407","4375239870"
"257370","명성티엔에스","9210","9210","0","0.00","0","0"
"009900","명신산업","16650","22400","5750","34.53","11870074","239397039150"
"267060","명진홀딩스","181","181","0","0.00","0","0"
"012690","모나리자","3495","3475","-20","-0.57","6969969","24162850820"
"005360","모나미","4165","3800","-365","-8.76","12791007","48002374750"
"080420","모다이노칩","3405","3390","-15","-0.44","5214382","17639559585"
"080160","모두투어","15650","16100","450","2.88","1619772","24550615200"
"204210","모두투어리츠","4560","4830","270","5.92","89508","421274035"
"100030","모바일리더","20750","21200","450","2.17","197435","4079795100"
"087260","모바일어플라이언스","3165","3415","250","7.90","21128893","73368602460"
"101330","모베이스","2920","3190","270","9.25","2224712","6888661020"
"012860","모베이스전자","1395","1510","115","8.24","24135571","36439732125"
"363260","모비데이즈","1515","1495","-20","-1.32","20617137","32759005095"
"348030","모비릭스","15100","18250","3150","20.86","22768621","420968866850"
"250060","모비스","1740","2455","715","41.09","44953690","110607343360"
"288980","모아데이타","3843","2380","-1463","-38.07","64594254","411679723110"
"033200","모아텍","5610","9680","4070","72.55","27000043","248296636190"
"009680","모토닉","8480","8510","30","0.35","241137","2068130400"
"118990","모트렉스","10850","12000","1150","10.60","27729234","329218995640"
"006920","모헨즈","3960","4540","580","14.65","5163772","23028101335"
"009580","무림P&P","3970","4715","745","18.77","6943005","30258738345"
"001810","무림SP","2690","3010","320","11.90","11830333","35911166525"
"009200","무림페이퍼","2590","2740","150","5.79","21860999","61947586000"
"135160","무송지오씨","2660","2550","-110","-4.14","136642","346276525"
"322970","무진메디","5010","4990","-20","-0.40","54988","271801745"
"033920","무학","6680","7060","380","5.69","2347636","16522884810"
"008420","문배철강","3620","3900","280","7.73","3741231","14236263570"
"279600","미디어젠","10450","9910","-540","-5.17","172126","1713901090"
"095500","미래나노텍","6030","9160","3130","51.91","80866016","680463317200"
"025560","미래산업","10100","11300","1200","11.88","578883","6307175950"
"218150","미래생명자원","6500","5910","-590","-9.08","16804530","105950120730"
"007120","미래아이앤지","314","347","33","10.51","47007401","17192245117"
"396690","미래에셋글로벌리츠","4775","4890","115","2.41","993051","4680420355"
"353490","미래에셋대우스팩 5호","2150","2120","-30","-1.40","2888723","6548760200"
"328380","미래에셋대우스팩3호","2130","2260","130","6.10","19782423","48158846200"
"357250","미래에셋맵스리츠","4275","4405","130","3.04","668149","2843953880"
"100790","미래에셋벤처투자","5650","6150","500","8.85","2160199","12903630570"
"412930","미래에셋비전스팩1호","2150","2125","-25","-1.16","732986","1562875150"
"085620","미래에셋생명","3115","3140","25","0.80","1099354","3359659005"
"006800","미래에셋증권","6470","6680","210","3.25","22397432","143094172420"
"00680K","미래에셋증권2우B","3785","3930","145","3.83","2341642","8964837555"
"006805","미래에셋증권우","4350","4890","540","12.41","186062","842794955"
"208890","미래엔에듀파트너","1485","1300","-185","-12.46","1315","1618195"
"049950","미래컴퍼니","19550","21550","2000","10.23","473032","9762258550"
"207760","미스터블루","5440","6300","860","15.81","4436907","27994040210"
"002840","미원상사","175000","179000","4000","2.29","30402","5436227500"
"268280","미원에스씨","198000","193000","-5000","-2.53","30782","5964773000"
"107590","미원홀딩스","132500","136500","4000","3.02","10679","1418537500"
"134380","미원화학","66100","66800","700","1.06","5923","391531800"
"003650","미창석유","81600","82700","1100","1.35","9724","781582000"
"059090","미코","8190","9090","900","10.99","1720634","14963753440"
"214610","미코바이오메드","12200","11100","-1100","-9.02","76963200","1024551506000"
"201490","미투온","4425","4860","435","9.83","4213459","20154598855"
"950190","미투젠","16300","15950","-350","-2.15","839986","14131028100"
"155900","바다로19호","3340","3345","5","0.15","452287","1512716415"
"206640","바디텍메드","12950","12350","-600","-4.63","6069528","84782809250"
"018700","바른손","2695","3030","335","12.43","27388282","83089304455"
"035620","바른손이앤에이","1055","1160","105","9.95","7310885","8243560010"
"064520","바른전자","7000","5630","-1370","-19.57","1650670","9261815200"
"053030","바이넥스","15100","15350","250","1.66","6635639","100649258450"
"301300","바이브컴퍼니","30500","32450","1950","6.39","476016","14925059950"
"064550","바이오니아","34150","33350","-800","-2.34","44166494","1656589954800"
"314930","바이오다인","27200","27950","750","2.76","233013","6555374750"
"208710","바이오로그디바이스","1430","1315","-115","-8.04","23370727","33794013240"
"086820","바이오솔루션","15050","15050","0","0.00","749664","11573349600"
"038460","바이오스마트","4000","4355","355","8.88","12558599","58577165640"
"281310","바이오시네틱스","7600","7600","0","0.00","0","0"
"251120","바이오에프디엔씨","24200","23300","-900","-3.72","1237428","28041128900"
"266470","바이오인프라생명과학","2110","1600","-510","-24.17","233277","419709040"
"086040","바이오톡스텍","7660","8380","720","9.40","16393231","145052036960"
"199290","바이오프로테크","1085","1060","-25","-2.30","5325","5150761"
"099430","바이오플러스","30500","31700","1200","3.93","13896338","439324644443"
"032980","바이온","1350","1215","-135","-10.00","3231594","3765599405"
"222160","바이옵트로","6520","6590","70","1.07","1983962","13400939770"
"308080","바이젠셀","9310","9540","230","2.47","5214430","50997694610"
"043150","바텍","30350","35350","5000","16.47","1023111","33751204250"
"323990","박셀바이오","40400","64900","24500","60.64","36360856","2207192941450"
"003610","방림","2925","3750","825","28.21","5419665","17677210750"
"267790","배럴","7940","7840","-100","-1.26","912769","7283583520"
"001340","백광산업","4290","4730","440","10.26","20381542","91451204685"
"046310","백금T&A","2830","3025","195","6.89","1489118","4213657300"
"035150","백산","9310","10150","840","9.02","6309103","62527931680"
"066410","버킷스튜디오","2005","3190","1185","59.10","609291071","1706614791450"
"002410","범양건영","4650","5420","770","16.56","33318911","172658879315"
"382900","범한퓨얼셀","33900","33650","-250","-0.74","8101853","254731634950"
"206400","베노홀딩스","3405","3455","50","1.47","1816213","6383534310"
"019010","베뉴지","2295","2240","-55","-2.40","9070199","20259095550"
"322190","베른","553","664","111","20.07","65822","36941956"
"177350","베셀","6790","7960","1170","17.23","21138408","158817600960"
"299910","베스파","3165","3165","0","0.00","0","0"
"096300","베트남개발1","205","209","4","1.95","1242929","256221804"
"007210","벽산","2735","2960","225","8.23","12014120","34112518045"
"225530","보광산업","6610","7040","430","6.51","19030386","132168340950"
"250000","보라티알","12000","12900","900","7.50","2808716","36679334050"
"002760","보락","1695","1770","75","4.42","3755958","6560256980"
"003850","보령","10350","11150","800","7.73","2854966","31084073600"
"310210","보로노이","48000","41500","-6500","-13.54","9783675","417302601750"
"006910","보성파워텍","5550","5640","90","1.62","32483826","174808286220"
"000890","보해양조","726","775","49","6.75","6378325","4771856693"
"226340","본느","1680","1745","65","3.87","2403650","4187441700"
"206950","볼빅","2950","3200","250","8.47","5849","18506740"
"003000","부광약품","8670","9730","1060","12.23","40264516","390776138330"
"001270","부국증권","21250","22600","1350","6.35","23332","496863600"
"001275","부국증권우","20200","20200","0","0.00","20624","412777950"
"026940","부국철강","3610","3985","375","10.39","2450241","9236976045"
"014470","부방","2250","2330","80","3.56","3142784","7171288010"
"011390","부산산업","86600","88900","2300","2.66","88468","7707236400"
"005030","부산주공","890","815","-75","-8.43","65698441","55117470251"
"008470","부스타","5200","5420","220","4.23","262405","1373410840"
"338220","뷰노","8120","7760","-360","-4.43","2137637","16650215290"
"100120","뷰웍스","34650","43250","8600","24.82","853939","34392850700"
"337930","브랜드엑스코퍼레이션","7280","8200","920","12.64","2064832","16332620990"
"099390","브레인즈컴퍼니","8520","8830","310","3.64","735861","6649137530"
"064480","브리지텍","4845","5480","635","13.11","1558389","8021038280"
"288330","브릿지바이오테라퓨틱스","9080","12600","3520","38.77","3335041","39643579840"
"365900","브이씨","12600","10650","-1950","-15.48","3012691","35216532300"
"251630","브이원텍","7400","7840","440","5.95","882428","6819894540"
"018290","브이티지엠피","5270","5470","200","3.80","3407157","18625910350"
"044480","블루베리 NFT","2455","2185","-270","-11.00","17653233","42903840785"
"033560","블루콤","9880","9720","-160","-1.62","374190","3644619140"
"191600","블루탑","6930","9670","2740","39.54","1003","7706250"
"369370","블리츠웨이","2810","3090","280","9.96","5758321","16966003895"
"126340","비나텍","41450","45650","4200","10.13","618980","25702349000"
"121800","비덴트","8920","10600","1680","18.83","166393038","1949681091390"
"148140","비디아이","640","640","0","0.00","0","0"
"082800","비보존 헬스케어","959","1005","46","4.80","8386948","8413710387"
"318410","비비씨","10700","11250","550","5.14","562891","6331362450"
"002070","비비안","1730","1950","220","12.72","11992552","23669024085"
"100220","비상교육","6120","6520","400","6.54","1870321","12490441260"
"146320","비씨엔씨","17000","17100","100","0.59","1644242","28215228200"
"200780","비씨월드제약","10200","10850","650","6.37","1347333","15287172350"
"141000","비아트론","8320","9040","720","8.65","783088","6944434800"
"090460","비에이치","25500","28250","2750","10.78","16697377","455544241150"
"083650","비에이치아이","7600","8300","700","9.21","22671090","167334227940"
"215050","비엔디생활건강","912","912","0","0.00","0","0"
"142760","비엘","6110","6230","120","1.96","26489251","197059160900"
"065170","비엘팜텍","936","920","-16","-1.71","3914444","3705936513"
"086220","비엘헬스케어","2585","2750","165","6.38","852","2246560"
"086670","비엠티","12050","16150","4100","34.02","4136897","60892790400"
"335890","비올","2000","2075","75","3.75","4751790","9791240630"
"138580","비즈니스온","8060","8340","280","3.47","653537","5348007070"
"082920","비츠로셀","11150","13450","2300","20.63","1676195","20753727300"
"054220","비츠로시스","5640","2365","-3275","-58.07","41019222","120052815500"
"042370","비츠로테크","7050","7120","70","0.99","1501644","10567224700"
"030790","비케이탑스","904","904","0","0.00","0","0"
"050090","비케이홀딩스","520","572","52","10.00","20660981","11986855109"
"307870","비투엔","2050","2260","210","10.24","33414015","91890936715"
"357880","비트나인","12000","11250","-750","-6.25","4295339","49879998750"
"032850","비트컴퓨터","6620","7240","620","9.37","7008948","51782230640"
"148780","비플라이소프트","2140","2165","25","1.17","28907648","216098403830"
"238200","비피도","8380","8360","-20","-0.24","393869","3225159720"
"093190","빅솔론","6100","6920","820","13.44","1193308","8119030380"
"065450","빅텍","5340","6040","700","13.11","23726434","138777344675"
"210120","빅텐츠","18950","20400","1450","7.65","1577","29115900"
"005180","빙그레","46650","47100","450","0.96","158994","7514302550"
"072950","빛샘전자","6550","7170","620","9.47","583345","4073158170"
"266170","뿌리깊은나무들","1430","1080","-350","-24.48","141577","135893991"
"143240","사람인에이치알","33100","34000","900","2.72","729314","24010950600"
"003960","사조대림","24600","26350","1750","7.11","392054","9630238000"
"008040","사조동아원","1600","1360","-240","-15.00","59228418","85291537485"
"007160","사조산업","45200","45300","100","0.22","169894","7585887150"
"014710","사조씨푸드","5160","5790","630","12.21","20267654","120203481985"
"006090","사조오양","9120","9350","230","2.52","350083","3176957610"
"100090","삼강엠앤티","19450","27000","7550","38.82","14973427","348084046750"
"122350","삼기","3120","3505","385","12.34","4075978","13992362490"
"014970","삼륭물산","5960","6820","860","14.43","8620642","57266146250"
"018310","삼목에스폼","18700","21600","2900","15.51","1050309","20970052300"
"053700","삼보모터스","4000","4800","800","20.00","6221274","31478042170"
"009620","삼보산업","1105","1275","170","15.38","11631716","14165686330"
"023600","삼보판지","9540","10100","560","5.87","598054","5863337460"
"001470","삼부토건","2160","2160","0","0.00","102240652","214278714405"
"006400","삼성SDI","537000","616000","79000","14.71","5451627","3102266613765"
"006405","삼성SDI우","274000","309500","35500","12.96","45887","13451188500"
"006660","삼성공조","10600","10650","50","0.47","207200","2184432050"
"380320","삼성머스트스팩5호","4490","4975","485","10.80","30853983","150867344780"
"028260","삼성물산","114000","123000","9000","7.89","5383182","632854750500"
"02826K","삼성물산우B","103500","112500","9000","8.70","65318","7130421000"
"207940","삼성바이오로직스","819000","904000","85000","10.38","1255349","1068852890300"
"032830","삼성생명","60200","62300","2100","3.49","4046480","241087356570"
"377630","삼성스팩4호","6020","8380","2360","39.20","81824724","628952129220"
"425290","삼성스팩6호","7560","6530","-1030","-13.62","46611167","319898569890"
"018260","삼성에스디에스","132500","131000","-1500","-1.13","2455449","325197733000"
"028050","삼성엔지니어링","20550","21800","1250","6.08","24831640","489340193150"
"009150","삼성전기","134500","134000","-500","-0.37","10961027","1522533975654"
"009155","삼성전기우","74800","76800","2000","2.67","104082","8113447600"
"005930","삼성전자","58700","59900","1200","2.04","299148330","18089719509626"
"005935","삼성전자우","53900","54700","800","1.48","18854833","1046608233961"
"001360","삼성제약","3330","3865","535","16.07","18354820","72814078665"
"010140","삼성중공업","5500","5970","470","8.55","74806086","418018112860"
"010145","삼성중공우","229500","231000","1500","0.65","8909","2017204000"
"016360","삼성증권","33650","35300","1650","4.90","5806349","193563955100"
"068290","삼성출판사","25550","27700","2150","8.41","1534030","41293442850"
"029780","삼성카드","30500","31800","1300","4.26","1546173","48078227468"
"000810","삼성화재","196500","202000","5500","2.80","1568889","312002375725"
"000815","삼성화재우","156000","158000","2000","1.28","114507","18001860500"
"006110","삼아알미늄","16900","23300","6400","37.87","5247610","112043531100"
"009300","삼아제약","14750","15400","650","4.41","230636","3527305450"
"145990","삼양사","41350","42600","1250","3.02","218789","9072308700"
"145995","삼양사우","32800","34900","2100","6.40","3647","124906100"
"003230","삼양식품","102500","111500","9000","8.78","1615287","172725195500"
"225190","삼양옵틱스","12650","12300","-350","-2.77","446750","5423951200"
"002170","삼양통상","53400","53300","-100","-0.19","27339","1445117600"
"272550","삼양패키징","17150","19800","2650","15.45","176561","3325991750"
"000070","삼양홀딩스","73500","74500","1000","1.36","300934","22044015000"
"000075","삼양홀딩스우","60000","59600","-400","-0.67","709","42352900"
"002810","삼영무역","13350","13600","250","1.87","100337","1356329850"
"361670","삼영에스앤씨","7000","7560","560","8.00","283082","2120594010"
"054540","삼영엠텍","5450","5790","340","6.24","43082651","232126298805"
"065570","삼영이엔씨","4890","7470","2580","52.76","17647262","109888320340"
"005680","삼영전자","10350","10450","100","0.97","564081","5861581200"
"003720","삼영화학","2475","3300","825","33.33","38188740","117990504575"
"023000","삼원강재","2580","2820","240","9.30","642644","1804324135"
"004380","삼익THK","12150","13850","1700","13.99","2341616","31863582450"
"002450","삼익악기","1410","1545","135","9.57","6502268","10304222935"
"032280","삼일","2155","2415","260","12.06","2572362","5875319600"
"002290","삼일기업공사","3720","4650","930","25.00","16697679","78158832530"
"004440","삼일씨엔에스","7540","9190","1650","21.88","1003951","9292244020"
"000520","삼일제약","7800","8100","300","3.85","2999290","24712419630"
"009770","삼정펄프","26250","29900","3650","13.90","1262154","36860313900"
"037460","삼지전자","9830","10300","470","4.78","508096","5175105930"
"032750","삼진","6750","7350","600","8.89","3477196","27786121370"
"054090","삼진엘앤디","3400","3455","55","1.62","70898574","243813633290"
"005500","삼진제약","24550","24500","-50","-0.20","2324473","58238857400"
"000250","삼천당제약","32650","36800","4150","12.71","3305819","116843758700"
"004690","삼천리","182000","194000","12000","6.59","603619","112068464000"
"024950","삼천리자전거","7680","7930","250","3.26","2226976","17218851920"
"038500","삼표시멘트","4050","4445","395","9.75","8653027","38261207740"
"017480","삼현철강","5500","5870","370","6.73","781573","4309755840"
"010960","삼호개발","3980","4270","290","7.29","968198","3990026215"
"046390","삼화네트웍스","3630","3825","195","5.37","18640284","69249446125"
"004450","삼화왕관","37050","42300","5250","14.17","995097","44100608650"
"009470","삼화전기","18250","19150","900","4.93","192943","3585713750"
"011230","삼화전자","2965","3050","85","2.87","407929","1240378555"
"001820","삼화콘덴서","39700","42450","2750","6.93","545407","23038826600"
"000390","삼화페인트","6690","8280","1590","23.77","4132383","33922245850"
"027580","상보","1495","1635","140","9.36","27495363","46227898820"
"038540","상상인","8740","9190","450","5.15","2920997","25714929180"
"101000","상상인인더스트리","747","782","35","4.69","17762820","15117878714"
"415580","상상인제3호스팩","2115","2105","-10","-0.47","376395","791770005"
"001290","상상인증권","960","1055","95","9.90","9716356","11083288542"
"041650","상신브레이크","3260","3385","125","3.83","415425","1402390100"
"091580","상신이디피","15900","18750","2850","17.92","8818647","157052017450"
"263810","상신전자","3370","3505","135","4.01","2013951","7059947600"
"089980","상아프론테크","29650","34650","5000","16.86","1219760","38521806350"
"042940","상지카일룸","1005","1025","20","1.99","17066239","17931616037"
"042600","새로닉스","20400","23850","3450","16.91","1387194","30755816550"
"075180","새론오토모티브","4830","4950","120","2.48","55070","269801995"
"252990","샘씨엔에스","5040","5000","-40","-0.79","5740642","29410215535"
"007540","샘표","57500","51800","-5700","-9.91","1093628","59393908450"
"248170","샘표식품","36000","38800","2800","7.78","1030147","41132378100"
"294630","서남","2730","2995","265","9.71","1472573","4216315235"
"038070","서린바이오","12650","16100","3450","27.27","31392986","536354773150"
"006730","서부T&D","7310","8560","1250","17.10","7796420","61884189290"
"079650","서산","2025","2195","170","8.40","1020546","2241168780"
"100660","서암기계공업","7680","6930","-750","-9.77","21731064","157704250930"
"007860","서연","7250","6950","-300","-4.14","2124218","15012273250"
"200880","서연이화","8130","8740","610","7.50","10240041","90634637620"
"019770","서연탑메탈","6330","5910","-420","-6.64","4429814","26259932230"
"017390","서울가스","243000","251000","8000","3.29","304192","73531413500"
"043710","서울리거","1025","957","-68","-6.63","2089642","2062591123"
"092190","서울바이오시스","7040","6950","-90","-1.28","5358810","39916506930"
"046890","서울반도체","10600","11200","600","5.66","3376716","36833670400"
"004410","서울식품","258","265","7","2.71","129798395","35374828481"
"004415","서울식품우","3230","3380","150","4.64","101825","347134425"
"063170","서울옥션","18800","23500","4700","25.00","7036192","145251228700"
"027040","서울전자통신","692","699","7","1.01","1990547","1322803963"
"018680","서울제약","4980","5310","330","6.63","3335667","20088670655"
"021050","서원","1410","1525","115","8.16","2511241","3600013835"
"093920","서원인텍","5650","5840","190","3.36","541065","3109985130"
"189860","서전기전","9440","9730","290","3.07","5562071","52096376530"
"178320","서진시스템","15150","15900","750","4.95","3494234","54064562450"
"122690","서진오토모티브","3085","3160","75","2.43","998535","3096597495"
"140070","서플러스글로벌","3400","3715","315","9.26","1773199","6391523145"
"011370","서한","1345","1485","140","10.41","12808188","18064630235"
"065710","서호전기","17850","18900","1050","5.88","89459","1654900300"
"008490","서흥","32200","36250","4050","12.58","245798","8453131800"
"035890","서희건설","1420","1520","100","7.04","11917443","16986778500"
"357550","석경에이티","17300","19100","1800","10.40","1844792","33902718050"
"003100","선광","90400","98900","8500","9.40","1035085","97816637200"
"007610","선도전기","3000","3000","0","0.00","0","0"
"067370","선바이오","17350","18300","950","5.48","102483","1778128450"
"171090","선익시스템","16400","17900","1500","9.15","3504553","61759235050"
"136490","선진","10150","11250","1100","10.84","1684922","17556334390"
"086710","선진뷰티사이언스","5940","6550","610","10.27","1583281","9977010590"
"014620","성광벤드","11050","14650","3600","32.58","13990785","169979365200"
"037350","성도이엔지","5200","5540","340","6.54","2468965","13008387655"
"014910","성문전자","1800","2030","230","12.78","4008413","7978829625"
"014915","성문전자우","8240","8750","510","6.19","12890","109333800"
"003080","성보화학","3590","3775","185","5.15","2410387","8702992450"
"004980","성신양회","9450","10600","1150","12.17","4960347","50563538890"
"004985","성신양회우","13350","15150","1800","13.48","1005824","16234106550"
"011300","성안","593","1085","492","82.97","159108557","157292832978"
"081580","성우전자","2905","3030","125","4.30","678497","1996771015"
"045300","성우테크론","4660","5030","370","7.94","4880361","24438063275"
"015750","성우하이텍","4370","5410","1040","23.80","41518300","225437519315"
"000180","성창기업지주","2000","2200","200","10.00","6555099","13996737705"
"080470","성창오토텍","6810","7540","730","10.72","602694","4449166110"
"043260","성호전자","1505","1490","-15","-1.00","8248001","12620192380"
"148150","세경하이테크","17000","19800","2800","16.47","1553509","30131699600"
"002420","세기상사","8360","9570","1210","14.47","674602","6471263850"
"053060","세동","1395","1610","215","15.41","11611100","17761327155"
"340440","세림B&G","4040","3810","-230","-5.69","182767441","717083310835"
"017510","세명전기","3920","3900","-20","-0.51","895946","3415563780"
"004360","세방","10350","12850","2500","24.15","982055","11328605720"
"004365","세방우","6830","7070","240","3.51","21259","147928330"
"004490","세방전지","50900","55100","4200","8.25","870512","45878624850"
"011560","세보엠이씨","8230","8610","380","4.62","1497307","12202229720"
"396300","세아메카닉스","6860","7760","900","13.12","65719849","496569396910"
"001430","세아베스틸지주","15100","15500","400","2.65","885078","13172823000"
"306200","세아제강","151000","175000","24000","15.89","529536","84677180000"
"003030","세아제강지주","128000","161500","33500","26.17","499882","73447542500"
"019440","세아특수강","14050","14150","100","0.71","173775","2393222200"
"058650","세아홀딩스","95800","102500","6700","6.99","3911","382345900"
"013000","세우글로벌","1640","1690","50","3.05","2603630","4271480930"
"100700","세운메디칼","3280","3510","230","7.01","10657362","38162364835"
"024830","세원물산","6280","6280","0","0.00","0","0"
"091090","세원이앤씨","636","846","210","33.02","77926515","64354670801"
"021820","세원정공","8090","8090","0","0.00","0","0"
"067830","세이브존I&C","2895","2900","5","0.17","699915","2044268595"
"033530","세종공업","5390","6150","760","14.10","7045592","42069162190"
"258830","세종메디칼","4140","5550","1410","34.06","215727396","1418519467915"
"036630","세종텔레콤","778","789","11","1.41","8002468","6438421223"
"039310","세중","2850","2925","75","2.63","1477461","4279430600"
"075580","세진중공업","5810","7530","1720","29.60","9333169","62422518720"
"067770","세진티에스","3615","3745","130","3.60","269542","1006462300"
"053450","세코닉스","7770","8170","400","5.15","1196052","9386835840"
"027970","세하","1315","1390","75","5.70","1783932","2417624885"
"252500","세화피앤씨","1350","1395","45","3.33","2981603","4043650345"
"347000","센코","12650","14600","1950","15.42","233855","3172021200"
"308170","센트랄모텍","12900","18600","5700","44.19","17041996","294675492500"
"012600","센트럴인사이트","2490","2490","0","0.00","0","0"
"331920","셀레믹스","7120","8600","1480","20.79","3910079","38250810720"
"049180","셀루메드","4415","6160","1745","39.52","48578386","288015373360"
"299660","셀리드","20450","23650","3200","15.65","12126867","312242879850"
"268600","셀리버리","16050","16950","900","5.61","10896078","299114781350"
"108860","셀바스AI","6910","7360","450","6.51","4573801","32875452750"
"208370","셀바스헬스케어","2305","2310","5","0.22","985848","2301199595"
"258250","셀젠텍","7050","6960","-90","-1.28","26810","185043740"
"068270","셀트리온","182500","212500","30000","16.44","9566417","1849352740000"
"068760","셀트리온제약","79400","89900","10500","13.22","2641140","219618381200"
"091990","셀트리온헬스케어","71500","79300","7800","10.91","14360704","1045153150300"
"060230","소니드","3640","4100","460","12.64","12904830","50073720975"
"290690","소룩스","8810","8580","-230","-2.61","396060","3428913870"
"053110","소리바다","3960","3960","0","0.00","0","0"
"950200","소마젠","5590","6160","570","10.20","2764951","17774041900"
"032680","소프트센","1770","1870","100","5.65","29659574","58034196205"
"032685","소프트센우","26350","24350","-2000","-7.59","26574","644119300"
"258790","소프트캠프","1725","1775","50","2.90","5034553","9523489110"
"066910","손오공","2305","2220","-85","-3.69","1765260","3989922620"
"043100","솔고바이오","574","592","18","3.14","5594321","3284550777"
"336370","솔루스첨단소재","42850","46900","4050","9.45","6830840","289696550350"
"33637K","솔루스첨단소재1우","10600","11450","850","8.02","606939","6273525530"
"33637L","솔루스첨단소재2우B","13800","14550","750","5.43","425095","6241921950"
"154040","솔루에타","2825","2885","60","2.12","327230","926237390"
"248070","솔루엠","19400","21450","2050","10.57","2058494","42015396650"
"035610","솔본","3695","4185","490","13.26","6041805","26396883455"
"357780","솔브레인","229600","225600","-4000","-1.74","461830","103938796600"
"036830","솔브레인홀딩스","19550","22100","2550","13.04","448327","9097582500"
"304100","솔트룩스","9320","10000","680","7.30","652792","6510072750"
"004430","송원산업","19800","19000","-800","-4.04","8383448","160038260450"
"086980","쇼박스","4860","5080","220","4.53","53798295","292911129535"
"050960","수산아이앤티","11150","12100","950","8.52","629205","7232139650"
"017550","수산중공업","3185","3115","-70","-2.20","16431516","49365588130"
"253840","수젠텍","15850","13900","-1950","-12.30","28036193","477512924400"
"185190","수프로","1520","1395","-125","-8.22","32133","82346820"
"236200","슈프리마","21700","24100","2400","11.06","593754","13961447850"
"317770","슈프리마아이디","14550","16100","1550","10.65","2082912","34545552400"
"094840","슈프리마에이치큐","6010","6640","630","10.48","416176","2620761570"
"192440","슈피겐코리아","38050","37700","-350","-0.92","94978","3572334400"
"136510","스마트솔루션즈","11600","11600","0","0.00","0","0"
"099440","스맥","2595","2660","65","2.50","27906216","71306617065"
"053210","스카이라이프","9070","9920","850","9.37","10067098","94881515240"
"033790","스카이문스테크놀로지","829","829","0","0.00","0","0"
"131100","스카이이앤엠","2935","3250","315","10.73","450748","1387103085"
"276040","스코넥","12150","13200","1050","8.64","4689720","61450974150"
"159910","스킨앤스킨","236","231","-5","-2.12","134918017","33837466287"
"115570","스타플렉스","4375","4375","0","0.00","629484","2716643505"
"258540","스템랩","2990","2460","-530","-17.73","91168","213929070"
"330730","스톤브릿지벤처스","5850","6120","270","4.62","9086757","58848747140"
"253450","스튜디오드래곤","73600","81900","8300","11.28","3075509","235829398500"
"204630","스튜디오산타클로스","7140","9100","1960","27.45","9969793","105051101530"
"026890","스틱인베스트먼트","7310","8240","930","12.72","13620520","110977242690"
"013810","스페코","5830","6480","650","11.15","11254914","69043687710"
"049830","승일","14850","14950","100","0.67","15053127","235301222450"
"020710","시공테크","5300","5580","280","5.28","3530679","19301183405"
"033170","시그네틱스","1635","1705","70","4.28","22546254","39137509915"
"048870","시너지이노베이션","3680","4195","515","13.99","6986138","27944186135"
"025320","시노펙스","3305","3395","90","2.72","118215843","406446169710"
"134790","시디즈","51100","48800","-2300","-4.50","1350159","72323223650"
"269620","시스웍","889","889","0","0.00","0","0"
"131090","시큐브","1055","1105","50","4.74","1444500","1549420475"
"232830","시큐센","2815","4270","1455","51.69","60173","209337665"
"139050","시티랩스","614","603","-11","-1.79","5374965","3247615116"
"016590","신대양제지","87000","86300","-700","-0.80","28813","2512783700"
"290520","신도기연","4885","5300","415","8.50","1812472","10036775245"
"029530","신도리코","31350","32100","750","2.39","231163","7317550086"
"004970","신라교역","10400","10750","350","3.37","128132","1361662100"
"001000","신라섬유","1765","2135","370","20.96","48771921","105699240595"
"025870","신라에스지","10500","11250","750","7.14","1273014","14683862200"
"215600","신라젠","12100","12100","0","0.00","0","0"
"065350","신성델타테크","10300","12000","1700","16.50","2713648","30250590960"
"011930","신성이엔지","1915","2380","465","24.28","143209420","316571776265"
"005390","신성통상","2945","3140","195","6.62","15810167","48483012990"
"004170","신세계","217500","228000","10500","4.83","1035446","225643570000"
"035510","신세계 I&C","13850","15150","1300","9.39","697558","9964215050"
"034300","신세계건설","25400","26750","1350","5.31","134897","3419569650"
"031430","신세계인터내셔날","29850","30100","250","0.84","2688061","79955363500"
"031440","신세계푸드","57800","62000","4200","7.27","123640","7386886300"
"006880","신송홀딩스","13050","10100","-2950","-22.61","11182818","124397385330"
"002800","신신제약","5250","5490","240","4.57","1320700","7351386960"
"344050","신영스팩6호","2285","2285","0","0.00","0","0"
"419270","신영스팩7호","2145","2135","-10","-0.47","316418","679073225"
"005800","신영와코루","11600","11900","300","2.59","172970","1997932950"
"001720","신영증권","55100","57100","2000","3.63","51721","2887623200"
"001725","신영증권우","57000","58200","1200","2.11","16015","916609400"
"009270","신원","1655","1790","135","8.16","15133610","25654355290"
"017000","신원종합개발","7230","7940","710","9.82","7816087","59661958200"
"002700","신일전자","2210","1905","-305","-13.80","46428900","96780342980"
"012790","신일제약","8900","9680","780","8.76","5682777","59846255310"
"138070","신진에스엠","5154","4135","-1019","-19.77","46159653","459626944845"
"226330","신테카바이오","9600","10900","1300","13.54","1516760","16077339730"
"019170","신풍제약","24600","28650","4050","16.46","34825891","1081154144900"
"019175","신풍제약우","46000","46150","150","0.33","278600","13822217550"
"002870","신풍제지","1580","1735","155","9.81","29173995","56834863460"
"404990","신한서부티엔디리츠","5020","4785","-235","-4.68","1656824","8011593515"
"293940","신한알파리츠","7790","7800","10","0.13","2154863","16740366200"
"333050","신한제6호스팩","2350","2165","-185","-7.87","24626846","65153490825"
"366330","신한제7호스팩","2135","2120","-15","-0.70","3474907","7798996905"
"393360","신한제8호스팩","2150","2150","0","0.00","248507","533953655"
"405640","신한제9호스팩","2145","2135","-10","-0.47","426825","910520440"
"055550","신한지주","36250","35950","-300","-0.83","29139397","1028971007035"
"056700","신화인터텍","4200","5120","920","21.90","193482553","1000639176820"
"187270","신화콘텍","5970","5830","-140","-2.35","10415541","62949396590"
"004080","신흥","16300","16000","-300","-1.84","35447","568911650"
"243840","신흥에스이씨","52600","58200","5600","10.65","948145","51943040100"
"257720","실리콘투","4425","2685","-1740","-39.32","44021378","218273275250"
"222800","심텍","38000","37800","-200","-0.53","18476059","741263696850"
"036710","심텍홀딩스","3840","4210","370","9.64","21979159","100027769965"
"160980","싸이맥스","13850","14450","600","4.33","546872","7996590400"
"356890","싸이버원","10800","11400","600","5.56","11782981","156423341750"
"217330","싸이토젠","58400","60100","1700","2.91","144254","8507641300"
"102280","쌍방울","545","541","-4","-0.73","101488007","55751151052"
"003410","쌍용C&E","6520","6880","360","5.52","10239541","66880334940"
"010280","쌍용정보통신","1160","1070","-90","-7.76","8370980","9101395945"
"003620","쌍용차","2770","2770","0","0.00","0","0"
"004770","써니전자","2725","2855","130","4.77","27433768","77998473155"
"217320","썬테크","6710","5310","-1400","-20.86","347","2404940"
"208640","썸에이지","1135","1180","45","3.96","21323348","26081251450"
"222420","쎄노텍","2035","2140","105","5.16","12471904","26614415465"
"037760","쎄니트","1660","1910","250","15.06","19594781","37754659205"
"099320","쎄트렉아이","32950","36300","3350","10.17","1277702","44326775000"
"015540","쎌마테라퓨틱스","6410","6410","0","0.00","0","0"
"049960","쎌바이오텍","13850","13650","-200","-1.44","214323","2963926500"
"050890","쏠리드","5040","5520","480","9.52","3858207","20434283745"
"066790","씨씨에스","549","519","-30","-5.46","3975858","2110283124"
"222080","씨아이에스","13650","15750","2100","15.38","22974156","335681685550"
"004920","씨아이테크","1270","1245","-25","-1.97","26116057","35135586835"
"236030","씨알푸드","6590","6930","340","5.16","74","480850"
"103660","씨앗","5950","5950","0","0.00","0","0"
"352480","씨앤씨인터내셔널","17400","19800","2400","13.79","592515","11812592750"
"245450","씨앤에스링크","2080","2060","-20","-0.96","14","29125"
"264660","씨앤지하이테크","11500","11800","300","2.61","480109","5860128550"
"352700","씨앤투스성진","5290","5680","390","7.37","9677783","55821162570"
"297090","씨에스베어링","9760","12600","2840","29.10","68606821","730645247210"
"112610","씨에스윈드","49150","65400","16250","33.06","7381312","405386351600"
"359090","씨엔알리서치","1780","1700","-80","-4.49","1666697","2881401410"
"286000","씨엔티드림","3210","2595","-615","-19.16","65327","168407950"
"115530","씨엔플러스","536","680","144","26.87","16097653","9954299791"
"115480","씨유메디칼","1075","1150","75","6.98","9720671","10714481018"
"376290","씨유테크","4660","5260","600","12.88","5820309","33154915090"
"189330","씨이랩","13150","13800","650","4.94","303705","4014784650"
"096530","씨젠","44700","39700","-5000","-11.19","19983469","885317624300"
"900120","씨케이에이치","252","269","17","6.75","40356830","10662822282"
"101240","씨큐브","6670","7110","440","6.60","324569","2193810430"
"060590","씨티씨바이오","8200","8830","630","7.68","1451744","12196643460"
"260930","씨티케이","7050","7850","800","11.35","729703","5418251350"
"013990","아가방컴퍼니","2960","3150","190","6.42","1705680","5194267105"
"123860","아나패스","22050","24050","2000","9.07","345892","8113247650"
"025980","아난티","6740","7620","880","13.06","9243237","64381408900"
"008700","아남전자","2350","2775","425","18.09","118225533","318238204780"
"058220","아리온","275","275","0","0.00","0","0"
"125210","아모그린텍","11100","13800","2700","24.32","6599085","81085476200"
"002790","아모레G","37800","35850","-1950","-5.16","2512323","93248269000"
"00279K","아모레G3우(전환)","31950","29550","-2400","-7.51","56205","1745608550"
"002795","아모레G우","14450","14150","-300","-2.08","156773","2247892600"
"090430","아모레퍼시픽","133000","126500","-6500","-4.89","5090795","666065728500"
"090435","아모레퍼시픽우","49800","47900","-1900","-3.82","396486","19183138997"
"357580","아모센스","12650","16150","3500","27.67","5515128","82920720150"
"052710","아모텍","21750","26400","4650","21.38","872772","21241519150"
"074430","아미노로직스","2740","2610","-130","-4.74","34283506","86997953275"
"092040","아미코젠","24300","26400","2100","8.64","1770430","43213274300"
"083930","아바코","10400","11750","1350","12.98","1285008","14095526550"
"149950","아바텍","15000","15950","950","6.33","465427","7747195350"
"036010","아비코전자","10050","12000","1950","19.40","4814274","52852704330"
"002030","아세아","114000","125000","11000","9.65","45651","5393924500"
"183190","아세아시멘트","11150","13050","1900","17.04","2976730","34568545720"
"002310","아세아제지","33700","37150","3450","10.24","392260","13857002800"
"050860","아세아텍","2850","3050","200","7.02","3386961","9960653575"
"012170","아센디오","1330","1140","-190","-14.29","5754363","6937570040"
"136410","아셈스","14000","15250","1250","8.93","5763446","87642269850"
"246720","아스타","4085","4265","180","4.41","348593","1457853615"
"067390","아스트","5090","5260","170","3.34","2034479","11320962375"
"159010","아스플로","7703","12150","4447","57.73","17662314","262599690200"
"127710","아시아경제","2075","2185","110","5.30","2680621","5983503330"
"267850","아시아나IDT","14300","14000","-300","-2.10","265144","3714769850"
"020560","아시아나항공","15250","15150","-100","-0.66","6362049","93835454650"
"154030","아시아종묘","4390","4440","50","1.14","3023277","14269756155"
"227610","아우딘퓨쳐스","1505","1760","255","16.94","5237070","8490843205"
"143160","아이디스","23450","26300","2850","12.15","243570","5985532100"
"054800","아이디스홀딩스","12700","13300","600","4.72","170284","2244987000"
"332370","아이디피","7730","8830","1100","14.23","666095","5588143420"
"122900","아이마켓코리아","10250","10350","100","0.98","751530","7662263210"
"339950","아이비김영","2135","2445","310","14.52","40057380","107657497540"
"099190","아이센스","32750","37450","4700","14.35","1970065","69012340700"
"289010","아이스크림에듀","4445","5190","745","16.76","21554248","120889703495"
"214430","아이쓰리시스템","17050","19050","2000","11.73","497433","9221207400"
"040910","아이씨디","9200","9610","410","4.46","321794","2992234130"
"068940","아이씨케이","3865","4170","305","7.89","18713957","73363210060"
"052860","아이앤씨","2950","3005","55","1.86","604419","1771465600"
"010780","아이에스동서","40800","41650","850","2.08","1330191","53311936300"
"069920","아이에스이커머스","8160","8000","-160","-1.96","8931787","73850024750"
"038880","아이에이","803","818","15","1.87","24125078","19571586328"
"307180","아이엘사이언스","4035","4025","-10","-0.25","2534392","9749999390"
"101390","아이엠","4780","5290","510","10.67","876580","4524251095"
"078860","아이오케이","721","745","24","3.33","17202144","13258276206"
"114810","아이원스","7310","8000","690","9.44","1676039","12972373240"
"090150","아이윈","1810","2320","510","28.18","40985381","91651333475"
"123010","아이윈플러스","720","692","-28","-3.89","46213513","29781849786"
"031310","아이즈비전","2900","3035","135","4.66","1480362","4469985640"
"185490","아이진","9650","10700","1050","10.88","7198445","76724302690"
"059100","아이컴포넌트","6510","6680","170","2.61","359561","2396057870"
"149010","아이케이세미콘","7970","7400","-570","-7.15","21310","160384420"
"262840","아이퀘스트","8880","9410","530","5.97","10779197","102332344490"
"175250","아이큐어","13300","12850","-450","-3.38","3756353","52451047200"
"052460","아이크래프트","3550","3730","180","5.07","5066399","20101220270"
"119830","아이텍","9380","8380","-1000","-10.66","6975451","64207891060"
"052770","아이톡시","2085","2085","0","0.00","0","0"
"124500","아이티센","4155","4310","155","3.73","1435337","5947196325"
"372800","아이티아이즈","12600","12500","-100","-0.79","7553970","89162327920"
"084850","아이티엠반도체","32050","35100","3050","9.52","419452","13903963750"
"114840","아이패밀리에스씨","12200","12700","500","4.10","1570493","19335964950"
"027360","아주IB투자","2965","3200","235","7.93","63627770","214113341925"
"139990","아주스틸","10400","11600","1200","11.54","1611087","18441299600"
"032080","아즈텍WB","2200","2550","350","15.91","28139451","73552103395"
"013310","아진산업","2705","3010","305","11.28","10025956","29176186050"
"059120","아진엑스텍","9550","11050","1500","15.71","4474528","47858402320"
"158430","아톤","28750","29900","1150","4.00","842069","24907553500"
"149300","아퓨어스","1680","1680","0","0.00","17398","28304145"
"067160","아프리카TV","83400","84800","1400","1.68","4643274","399419115900"
"001540","안국약품","8370","9310","940","11.23","4797694","47850244080"
"053800","안랩","88900","92500","3600","4.05","3356415","303146270700"
"251280","안지오랩","9970","9400","-570","-5.72","27220","244812320"
"065660","안트로젠","21400","22400","1000","4.67","1107331","24431408950"
"297570","알로이스","1635","2115","480","29.36","102301564","222176272450"
"001780","알루코","2950","3205","255","8.64","12629018","38781696210"
"260660","알리코제약","6240","6810","570","9.13","2049684","14019308710"
"361570","알비더블유","17950","18200","250","1.39","10320306","204355362300"
"131370","알서포트","4720","5190","470","9.96","23497517","127689343490"
"140670","알에스오토메이션","13350","15600","2250","16.85","8161116","128725826300"
"096610","알에프세미","3080","4150","1070","34.74","17155142","71488350550"
"061040","알에프텍","5280","5690","410","7.77","3738910","20465171030"
"148250","알엔투테크놀로지","8330","8100","-230","-2.76","1788486","15087071960"
"347860","알체라","13700","16100","2400","17.52","1467011","22003938500"
"196170","알테오젠","63900","74600","10700","16.74","8618688","588085723500"
"123750","알톤스포츠","3205","3610","405","12.64","8608847","31129391700"
"085810","알티캐스트","1600","1745","145","9.06","3864087","6600549030"
"117670","알파홀딩스","2490","2330","-160","-6.43","4884024","11763100780"
"291650","압타머사이언스","13200","10650","-2550","-19.32","11846636","150176329350"
"293780","압타바이오","17050","18950","1900","11.14","31695368","712283092000"
"267810","앙츠","1335","1490","155","11.61","3770","5494195"
"018250","애경산업","14450","14150","-300","-2.08","410984","5959112800"
"161000","애경케미칼","8260","8580","320","3.87","1617274","13195257940"
"196300","애니젠","9470","9440","-30","-0.32","214155","1980701390"
"310200","애니플러스","2860","3210","350","12.24","7878410","25120377480"
"179530","애드바이오텍","4780","5130","350","7.32","2001206","9792345710"
"900100","애머릿지","3585","3585","0","0.00","0","0"
"205500","액션스퀘어","2700","3345","645","23.89","14657245","47555428435"
"052790","액토즈소프트","9040","9890","850","9.40","523023","4948639090"
"290740","액트로","7230","7390","160","2.21","991958","7181770250"
"238090","앤디포스","6800","7300","500","7.35","5329998","39995231210"
"092600","앤씨앤","2905","2420","-485","-16.70","4973604","12520544335"
"129890","앱코","11450","11450","0","0.00","1024864","11649279500"
"174900","앱클론","11450","12750","1300","11.35","3197783","41065379000"
"255440","야스","9170","9380","210","2.29","239005","2283439840"
"030960","양지사","7420","16000","8580","115.63","20298926","273754087740"
"102120","어보브반도체","9950","10750","800","8.04","1763976","18203885610"
"263540","어스앤에어로스페이스","10900","10900","0","0.00","0","0"
"238120","얼라인드","9860","10100","240","2.43","555513","5546675460"
"224810","엄지하우스","6470","4775","-1695","-26.20","4618","20594555"
"019990","에너토크","10700","12000","1300","12.15","3497750","38187845380"
"011090","에넥스","1370","1600","230","16.79","16716597","25599644675"
"270660","에브리봇","29500","35750","6250","21.19","7882194","289412084300"
"038680","에스넷","5560","6150","590","10.61","5026284","32387841580"
"137310","에스디바이오센서","43900","39200","-4700","-10.71","15566976","700219608650"
"217480","에스디생명공학","1960","2930","970","49.49","14376144","39392143550"
"121890","에스디시스템","739","739","0","0.00","0","0"
"097780","에스맥","3385","3385","0","0.00","0","0"
"042110","에스씨디","2250","1870","-380","-16.89","19595701","40287193110"
"298060","에스씨엠생명과학","10950","11200","250","2.28","1119061","12864743400"
"065420","에스아이리소스","699","784","85","12.16","52805589","41510710970"
"270210","에스알바이오텍","4205","3870","-335","-7.97","2734","10414390"
"103230","에스앤더블류","2505","2505","0","0.00","0","0"
"260970","에스앤디","19050","20000","950","4.99","280726","5352578950"
"101490","에스앤에스텍","19650","20200","550","2.80","1969489","39627206750"
"095910","에스에너지","4335","5420","1085","25.03","54995481","269282214665"
"275630","에스에스알","4780","5530","750","15.69","392627","2060516815"
"031330","에스에이엠티","3540","3680","140","3.95","2769069","10063873270"
"060540","에스에이티","2715","2705","-10","-0.37","3003708","8081133305"
"351320","에스에이티이엔지","3570","3615","45","1.26","2098714","7652431300"
"056190","에스에프에이","39850","42450","2600","6.52","2566175","106622590100"
"080000","에스엔유","2895","3020","125","4.32","1015509","3039950095"
"086460","에스엔피제네틱스","10000","7900","-2100","-21.00","13753","106122180"
"005850","에스엘","28900","30900","2000","6.92","4064440","127074596700"
"214310","에스엘바이오닉스","3490","5800","2310","66.19","3648800","17480357440"
"246250","에스엘에스바이오","7100","7000","-100","-1.41","61849","451889300"
"041510","에스엠","68500","74400","5900","8.61","8091739","573114053000"
"010580","에스엠벡셀","1530","1530","0","0.00","0","0"
"299670","에스엠비나","3000","2785","-215","-7.17","155","441675"
"007820","에스엠코어","6140","7050","910","14.82","5805074","39259962780"
"109610","에스와이","3775","3705","-70","-1.85","32405355","118098600960"
"012750","에스원","63700","62400","-1300","-2.04","929078","58618972950"
"306040","에스제이그룹","21050","22050","1000","4.75","456680","9736946450"
"217910","에스제이켐","310","304","-6","-1.94","42669","12956073"
"224020","에스케이씨에스","3740","4340","600","16.04","13938","54222170"
"408920","에스케이증권7호스팩","2185","2185","0","0.00","0","0"
"096630","에스코넥","1170","1235","65","5.56","1786757","2111637430"
"069510","에스텍","6650","7510","860","12.93","376610","2748993900"
"041910","에스텍파마","7720","8860","1140","14.77","3348781","29931300260"
"234300","에스트래픽","3880","4110","230","5.93","2257948","9708509580"
"039440","에스티아이","15750","15300","-450","-2.86","3318739","53635848550"
"098660","에스티오","2370","2300","-70","-2.95","908045","2034799655"
"052020","에스티큐브","7160","19250","12090","168.85","34447499","466150705820"
"237690","에스티팜","95100","117400","22300","23.45","2879857","294605035000"
"050760","에스폴리텍","3395","3590","195","5.74","6396668","23765774000"
"288620","에스퓨얼셀","22100","24550","2450","11.09","1592660","36117038000"
"317830","에스피시스템스","10100","10500","400","3.96","8930161","91712463242"
"058610","에스피지","12850","17300","4450","34.63","18280518","274922798550"
"043340","에쎈테크","1240","1015","-225","-18.15","8695970","9562891150"
"023960","에쓰씨엔지니어링","2365","2275","-90","-3.81","6221828","14139238055"
"298690","에어부산","3859","3575","-284","-7.36","4805804","7929875295"
"187660","에이디엠코리아","3150","3115","-35","-1.11","3832731","12313579940"
"054630","에이디칩스","291","352","61","20.96","98817602","38698732907"
"200710","에이디테크놀로지","13300","14100","800","6.02","852005","11738316750"
"096690","에이루트","428","521","93","21.73","177337212","96206616385"
"140910","에이리츠","5570","5640","70","1.26","110018","595013690"
"078520","에이블씨엔씨","5260","5230","-30","-0.57","909649","4799563530"
"298380","에이비엘바이오","25500","25550","50","0.20","12235584","293732262450"
"203400","에이비온","8150","10700","2550","31.29","2840252","27920081420"
"195990","에이비프로바이오","854","843","-11","-1.29","34613270","30156433004"
"003800","에이스침대","40950","43000","2050","5.01","11964","503770150"
"088800","에이스테크","7240","7880","640","8.84","4109121","31088128820"
"241840","에이스토리","27750","26600","-1150","-4.14","17699152","548273570000"
"312610","에이에프더블류","3345","3740","395","11.81","4069045","15864751235"
"015260","에이엔피","2445","2330","-115","-4.70","4435826","10191113680"
"234070","에이원알폼","24850","24850","0","0.00","0","0"
"072990","에이치시티","11000","10600","-400","-3.64","507857","5592174900"
"227100","에이치앤비디자인","7090","4800","-2290","-32.30","4566501","26225672850"
"044990","에이치엔에스하이텍","12150","12150","0","0.00","0","0"
"239610","에이치엘사이언스","35450","30800","-4650","-13.12","61907","1989441400"
"353070","에이치엠씨제4호스팩","2115","2105","-10","-0.47","175485","371467015"
"353060","에이치엠씨제5호스팩","2120","2100","-20","-0.94","187274","393929330"
"044780","에이치케이","1830","1895","65","3.55","1746276","3156181765"
"357230","에이치피오","9610","11900","2290","23.83","4353426","53001051190"
"071670","에이테크솔루션","12600","13250","650","5.16","1403731","17766985000"
"045660","에이텍","12550","12900","350","2.79","4762832","60543165150"
"224110","에이텍티앤","13200","12250","-950","-7.20","1759184","22885251050"
"230980","에이트원","849","1010","161","18.96","32555410","34151458762"
"021080","에이티넘인베스트","3190","3490","300","9.40","18057238","63184472315"
"089530","에이티세미콘","1130","1095","-35","-3.10","18061650","20128340577"
"200470","에이팩트","4000","5040","1040","26.00","23816956","132960610070"
"207490","에이펙스인텍","7450","8010","560","7.52","2490","19985140"
"262260","에이프로","11150","13350","2200","19.73","3106874","41204518900"
"007460","에이프로젠","1595","1510","-85","-5.33","60961441","94291766130"
"109960","에이프로젠 H&G","518","536","18","3.47","2972303","1582924509"
"003060","에이프로젠제약","595","674","79","13.28","18500612","12107096384"
"244920","에이플러스에셋","6030","6320","290","4.81","1874935","11733088120"
"089970","에이피티씨","16050","17250","1200","7.48","3310543","54385431250"
"230240","에치에프알","27650","33600","5950","21.52","1897981","58191356200"
"230360","에코마케팅","14800","18050","3250","21.96","5488975","94714175100"
"038870","에코바이오","6720","6860","140","2.08","942985","6326244600"
"128540","에코캡","6230","8020","1790","28.73","56958181","435418018230"
"086520","에코프로","71400","119500","48100","67.37","26580971","2557250377400"
"247540","에코프로비엠","118900","122700","3800","3.20","26348351","3139937155400"
"383310","에코프로에이치엔","37750","60900","23150","61.32","7635771","409802174500"
"038110","에코플라스틱","2735","3005","270","9.87","49360795","147290909150"
"073540","에프알텍","3070","3120","50","1.63","718742","2205139075"
"064850","에프앤가이드","6410","8000","1590","24.80","5222215","40618677200"
"064090","에프앤리퍼블릭","2585","2790","205","7.93","393637","1050913970"
"036810","에프에스티","14650","15300","650","4.44","948628","14142928850"
"173940","에프엔씨엔터","5900","5630","-270","-4.58","388440","2261554850"
"083500","에프엔에스테크","8010","9330","1320","16.48","737894","6350475730"
"054940","엑사이엔씨","1140","1200","60","5.26","2545485","2903798955"
"950130","엑세스바이오","17200","17500","300","1.74","50395013","998633940600"
"205100","엑셈","3785","4175","390","10.30","6561223","26548891255"
"070300","엑스큐어","2555","3105","550","21.53","388985","1151074305"
"092870","엑시콘","9280","9800","520","5.60","846861","8259306830"
"317870","엔바이오니아","11200","8550","-2650","-23.66","786917","7280016950"
"067570","엔브이에이치코리아","3465","3770","305","8.80","1448750","5221731710"
"236810","엔비티","7390","7170","-220","-2.98","3456560","26158297680"
"140610","엔솔바이오사이언스","14000","13000","-1000","-7.14","140743","1881381300"
"333620","엔시스","13500","15000","1500","11.11","472902","6660240050"
"101400","엔시트론","781","793","12","1.54","6017856","4746070513"
"036570","엔씨소프트","373500","402500","29000","7.76","2167358","820665051750"
"217820","엔에스","8360","8790","430","5.14","1614095","14590514860"
"031860","엔에스엔","1200","1280","80","6.67","21933404","26597967090"
"238170","엔에스엠","766","849","83","10.84","39266","27347927"
"224760","엔에스컴퍼니","3295","2450","-845","-25.64","6092","15962555"
"380440","엔에이치스팩19호","2100","2080","-20","-0.95","1529431","3202212035"
"391060","엔에이치스팩20호","2100","2085","-15","-0.71","642949","1345985855"
"396770","엔에이치스팩22호","2150","2150","0","0.00","236981","509735720"
"422040","엔에이치스팩23호","2115","2115","0","0.00","465052","987889920"
"265740","엔에프씨","11250","10900","-350","-3.11","443284","4942035400"
"354200","엔젠바이오","8180","8840","660","8.07","2155891","22137768580"
"093510","엔지브이아이","2000","2000","0","0.00","100","198875"
"208860","엔지스테크널러지","2205","2205","0","0.00","0","0"
"183490","엔지켐생명과학","17000","21000","4000","23.53","11571237","266923922900"
"085310","엔케이","873","991","118","13.52","1878860","1712279816"
"182400","엔케이맥스","15300","17000","1700","11.11","10574857","174480794350"
"348370","엔켐","47100","57700","10600","22.51","2702493","136588695350"
"069410","엔텔스","5640","6090","450","7.98","889089","5368862210"
"227950","엔투텍","1385","1330","-55","-3.97","8257667","11578416395"
"291230","엔피","7210","7760","550","7.63","13392215","107274488970"
"198080","엔피디","2380","2550","170","7.14","372528","922969285"
"048830","엔피케이","2020","2245","225","11.14","3285932","7102785930"
"096870","엘디티","3685","3695","10","0.27","399359","1475096930"
"276240","엘리비젼","598","749","151","25.25","16375","9387793"
"900140","엘브이엠씨홀딩스","2920","3070","150","5.14","3109770","9138171100"
"376190","엘비루셈","7310","7760","450","6.16","361567","2766190780"
"061970","엘비세미콘","8310","9360","1050","12.64","7972830","72343912390"
"138690","엘아이에스","982","982","0","0.00","0","0"
"290650","엘앤씨바이오","31700","28550","-3150","-9.94","2856134","86481307050"
"066970","엘앤에프","214200","245600","31400","14.66","9934579","2249386899200"
"156100","엘앤케이바이오","10350","11450","1100","10.63","1071664","12621388050"
"311060","엘에이티","3800","4700","900","23.68","10301","41385045"
"073110","엘엠에스","7960","8070","110","1.38","297226","2373691580"
"083310","엘오티베큠","12450","11650","-800","-6.43","2262410","27964549900"
"037950","엘컴텍","1150","1185","35","3.04","7113344","8287233225"
"170920","엘티씨","8130","8800","670","8.24","300929","2492665170"
"058630","엠게임","7590","8280","690","9.09","6597389","52694749430"
"058970","엠로","16500","15350","-1150","-6.97","738884","11975872250"
"019590","엠벤처투자","1205","1475","270","22.41","16329876","23318429375"
"169330","엠브레인","3545","3585","40","1.13","552229","1953000175"
"097520","엠씨넥스","31050","34600","3550","11.43","1130918","36874914200"
"179290","엠아이텍","9170","12400","3230","35.22","11824267","125108059880"
"009780","엠에스씨","5790","6090","300","5.18","141421","843777250"
"123040","엠에스오토텍","4295","4930","635","14.78","2602200","12480858360"
"323230","엠에프엠코리아","889","946","57","6.41","1031918","948100695"
"033160","엠케이전자","11000","13300","2300","20.91","3745387","44926394750"
"347890","엠투아이","8250","9500","1250","15.15","2600155","23515745160"
"033310","엠투엔","6400","8690","2290","35.78","17740917","147226037540"
"259630","엠플러스","14750","16700","1950","13.22","2248597","36263996900"
"065150","엠피대산","569","562","-7","-1.23","2589459","1463385256"
"115960","연우","17250","18000","750","4.35","494932","8581562550"
"090740","연이비앤티","2105","2105","0","0.00","0","0"
"060850","영림원소프트랩","8630","10550","1920","22.25","3532857","36039467020"
"014440","영보화학","3625","4235","610","16.83","5138095","21222025025"
"007530","영신금속","2705","2675","-30","-1.11","442477","1186013705"
"143540","영우디에스피","1530","1920","390","25.49","110605194","220284953880"
"111770","영원무역","39650","41900","2250","5.67","1977400","79384834278"
"009970","영원무역홀딩스","47300","46800","-500","-1.06","382667","18250652500"
"003520","영진약품","3555","3615","60","1.69","7197358","26008413010"
"000670","영풍","511000","588000","77000","15.07","19898","10691048500"
"036560","영풍정밀","8560","9200","640","7.48","1802268","17085007890"
"006740","영풍제지","7280","7270","-10","-0.14","5139611","38202699040"
"012280","영화금속","1100","1200","100","9.09","4211239","4864821930"
"265560","영화테크","12700","14000","1300","10.24","2873514","38481287700"
"012160","영흥","785","848","63","8.03","2664342","2192844321"
"036000","예림당","1900","1980","80","4.21","379111","726090590"
"250930","예선테크","1325","1460","135","10.19","5902024","8744804100"
"053280","예스24","6370","6750","380","5.97","1263000","8374077680"
"015360","예스코홀딩스","34600","35100","500","1.45","57128","2010342250"
"122640","예스티","6760","9120","2360","34.91","1925951","15512845470"
"900300","오가닉티코스메틱","348","330","-18","-5.17","22878292","7707154227"
"045060","오공","3655","3825","170","4.65","6277344","25532939370"
"080520","오디텍","5480","5660","180","3.28","1192091","6556754870"
"007310","오뚜기","433500","465000","31500","7.27","275904","124106875500"
"039830","오로라","7940","8730","790","9.95","481479","4010179850"
"322310","오로스테크놀로지","15150","14850","-300","-1.98","384458","5642657250"
"046120","오르비텍","6970","7360","390","5.60","69235862","490681260030"
"014940","오리엔탈정공","2805","3365","560","19.96","8322772","27616926145"
"002630","오리엔트바이오","760","834","74","9.74","8958162","7368649349"
"065500","오리엔트정공","1595","1900","305","19.12","2900718","5065054830"
"271560","오리온","106000","105000","-1000","-0.94","2957081","305429892000"
"001800","오리온홀딩스","14950","15000","50","0.33","1412056","21158640300"
"010470","오리콤","6850","6520","-330","-4.82","2180010","14071833710"
"352910","오비고","10950","11550","600","5.48","2732664","31464233350"
"053980","오상자이엘","6080","6600","520","8.55","22008160","165073674190"
"052420","오성첨단소재","2150","2150","0","0.00","0","0"
"241790","오션브릿지","11000","12500","1500","13.64","724344","8902896950"
"329020","오션스톤","1485","1300","-185","-12.46","19095","26965735"
"039200","오스코텍","28150","28150","0","0.00","3043377","86820035100"
"226400","오스테오닉","3025","2945","-80","-2.64","759159","2270088745"
"031510","오스템","1805","2010","205","11.36","16538768","35314837610"
"048260","오스템임플란트","99300","110100","10800","10.88","3799156","395542677850"
"138080","오이솔루션","22150","23650","1500","6.77","436237","10106472550"
"080580","오킨스전자","21450","20150","-1300","-6.06","1507624","30509511300"
"067170","오텍","7660","7450","-210","-2.74","1255614","9800831240"
"353590","오토앤","11550","13700","2150","18.61","10104191","132438565600"
"173130","오파스넷","6140","5490","-650","-10.59","9233823","51261871900"
"049480","오픈베이스","2825","3080","255","9.03","16903128","51788342635"
"309930","오하임아이엔티","3120","3590","470","15.06","8963451","31582045980"
"244460","올리패스","5800","5770","-30","-0.52","4714231","27015026340"
"226950","올릭스","23500","23100","-400","-1.70","2296028","52891655200"
"057540","옴니시스템","2635","2240","-395","-14.99","54467126","139149631710"
"131030","옵투스제약","6160","6650","490","7.95","939148","6413262770"
"082210","옵트론텍","5340","5640","300","5.62","5945914","33161254910"
"109080","옵티시스","11800","14050","2250","19.07","2187557","31474195850"
"153710","옵티팜","8620","9940","1320","15.31","6063956","60753142740"
"321820","와이더플래닛","7500","7900","400","5.33","319481","2472873530"
"122990","와이솔","8590","8970","380","4.42","855528","7470848670"
"232140","와이아이케이","4140","4280","140","3.38","1445535","6035904495"
"065530","와이어블","2680","2950","270","10.07","15243984","46237551655"
"067900","와이엔텍","9220","10050","830","9.00","2789401","28424291400"
"155650","와이엠씨","6210","6020","-190","-3.06","709248","4388987020"
"273640","와이엠텍","15000","16800","1800","12.00","649625","10293196650"
"251370","와이엠티","12600","15200","2600","20.63","3471523","50928177400"
"066430","와이오엠","2005","1880","-125","-6.23","1085125","2140759160"
"193250","와이제이엠게임즈","2100","2150","50","2.38","17433778","37854047215"
"273060","와이즈버즈","1290","1295","5","0.39","1715584","2255774130"
"019210","와이지-원","6650","7450","800","12.03","2276501","15607619010"
"122870","와이지엔터테인먼트","49650","59000","9350","18.83","4694544","257319136750"
"011690","와이투솔루션","800","710","-90","-11.25","24438193","17028006716"
"332570","와이팜","4660","4760","100","2.15","1359818","6480639150"
"079000","와토스코리아","5630","6570","940","16.70","4774626","31773683840"
"070960","용평리조트","4005","4050","45","1.12","1195560","4737396820"
"316140","우리금융지주","11600","12100","500","4.31","52098633","612523870214"
"032820","우리기술","2225","2085","-140","-6.29","62569337","130770575950"
"041190","우리기술투자","5530","6320","790","14.29","69440610","435416414880"
"115440","우리넷","8730","8980","250","2.86","1595660","14117594660"
"046970","우리로","1485","1600","115","7.74","9331758","14528231185"
"082850","우리바이오","3175","3795","620","19.53","86343415","350128326960"
"215360","우리산업","14700","16300","1600","10.88","4535432","73068425750"
"072470","우리산업홀딩스","4450","5570","1120","25.17","46782583","256713985900"
"073560","우리손에프앤지","1965","1985","20","1.02","16276645","31518032690"
"037400","우리엔터프라이즈","2310","2635","325","14.07","11496447","30170933920"
"153490","우리이앤엘","1195","1355","160","13.39","6835906","9002658320"
"010050","우리종금","884","972","88","9.95","56626247","52332009359"
"101170","우림피티에스","8950","9100","150","1.68","47648734","430826480940"
"006980","우성","24900","25150","250","1.00","176589","4320060500"
"066590","우수AMS","3810","4010","200","5.25","7056309","28432055570"
"017370","우신시스템","2470","2670","200","8.10","2398612","6289034485"
"103840","우양","3800","4010","210","5.53","1600198","6419046950"
"046940","우원개발","4305","5410","1105","25.67","18220330","89846374875"
"215380","우정바이오","4970","5050","80","1.61","2960698","15548712865"
"065680","우주일렉트로","21400","21450","50","0.23","893964","18820100900"
"105840","우진","11900","13600","1700","14.29","29885319","374187809450"
"018620","우진비앤지","2115","2180","65","3.07","20183276","42873418440"
"010400","우진아이엔에스","6020","6620","600","9.97","787004","5366507200"
"049800","우진플라임","3385","3900","515","15.21","701036","2538176585"
"016880","웅진","1395","1500","105","7.53","9740796","14426083695"
"095720","웅진씽크빅","2380","2605","225","9.45","4490414","11493679670"
"005820","원림","22800","25350","2550","11.18","94726","2408753300"
"307280","원바이오젠","1625","1635","10","0.62","1144935","1866332430"
"053080","원방테크","10550","12100","1550","14.69","1859450","21317065200"
"032940","원익","3675","3835","160","4.35","350030","1319829285"
"240810","원익IPS","28700","29350","650","2.26","8098143","242913264960"
"074600","원익QnC","26600","24750","-1850","-6.95","9799082","243757294850"
"104830","원익머트리얼즈","30850","31650","800","2.59","1889940","57791306500"
"014190","원익큐브","2460","2750","290","11.79","8705015","23635487460"
"131390","원익피앤이","20650","21000","350","1.69","2300455","48188781350"
"030530","원익홀딩스","3835","3995","160","4.17","3144889","12251131185"
"012620","원일특강","11500","12150","650","5.65","3637528","44487613500"
"382840","원준","41368","35400","-5968","-14.43","9269152","378824172650"
"336570","원텍","3025","2980","-45","-1.49","23728138","72685740560"
"376980","원티드랩","21900","23200","1300","5.94","2691029","64127772750"
"122830","원포유","1890","1955","65","3.44","313892","588984730"
"008370","원풍","4880","5040","160","3.28","346330","1716254005"
"008290","원풍물산","736","862","126","17.12","7829506","6898106513"
"101160","월덱스","18550","19050","500","2.70","2669890","50771854700"
"336060","웨이버스","1720","1755","35","2.03","6663214","11603244590"
"095270","웨이브일렉트로","5580","5430","-150","-2.69","863850","4672100000"
"010600","웰바이오텍","1650","1715","65","3.94","43953946","78779154080"
"065950","웰크론","3355","3590","235","7.00","10710986","39479287730"
"076080","웰크론한텍","2935","4410","1475","50.26","100659507","424784845080"
"196700","웹스","3440","3980","540","15.70","46207120","179984343090"
"069080","웹젠","18700","20800","2100","11.23","1424919","27889229250"
"053580","웹케시","16450","20300","3850","23.40","1084898","20200741650"
"071460","위니아","2790","2550","-240","-8.60","1820914","4683342495"
"377460","위니아에이드","11700","9150","-2550","-21.79","7370544","73961133910"
"044340","위닉스","12150","13000","850","7.00","640973","7872653550"
"330350","위더스제약","8530","8930","400","4.69","605809","5441237360"
"348350","위드텍","15300","15100","-200","-1.31","209441","3170429450"
"112040","위메이드","59100","71200","12100","20.47","21821247","1468304092200"
"101730","위메이드맥스","18150","22900","4750","26.17","23194896","489029409200"
"123420","위메이드플레이","23550","28300","4750","20.17","4579729","121948120200"
"065370","위세아이텍","11350","11250","-100","-0.88","400554","4569157700"
"140660","위월드","2400","2495","95","3.96","10413","24403000"
"038620","위즈코프","1130","1200","70","6.19","25615371","30738579590"
"299900","위지윅스튜디오","21750","25550","3800","17.47","9378159","221413026500"
"036090","위지트","839","1020","181","21.57","129196578","137020694602"
"136540","윈스","13600","14300","700","5.15","412255","5723945900"
"320000","윈텍","2125","2335","210","9.88","6338414","15189157680"
"097800","윈팩","1400","1460","60","4.29","1394791","1986286905"
"192390","윈하이텍","3615","4040","425","11.76","2081009","8024782045"
"313760","윌링스","11100","11700","600","5.41","1570132","17948359850"
"008600","윌비스","931","1000","69","7.41","7984270","7779439435"
"900340","윙입푸드","1365","1200","-165","-12.09","24655886","31682235075"
"033270","유나이티드제약","23550","25700","2150","9.13","1548284","39950203300"
"064510","유네코","2750","2750","0","0.00","0","0"
"014830","유니드","89000","96100","7100","7.98","1541305","146301350900"
"036200","유니셈","7360","7350","-10","-0.14","13653178","103197095990"
"018000","유니슨","2370","2790","420","17.72","22860368","58370617780"
"000910","유니온","5790","6430","640","11.05","25605952","165877407870"
"047400","유니온머티리얼","2230","3440","1210","54.26","273845641","906288300120"
"203450","유니온커뮤니티","2795","3235","440","15.74","4468445","14873159630"
"011330","유니켐","1200","1190","-10","-0.83","1867066","2215659385"
"077500","유니퀘스트","9000","9200","200","2.22","1759734","16335678570"
"011320","유니크","6520","7110","590","9.05","13363621","89754694200"
"086390","유니테스트","17850","19200","1350","7.56","3581100","65745736850"
"241690","유니테크노","5650","5840","190","3.36","2873286","16441974530"
"142210","유니트론텍","3695","4010","315","8.53","1596407","6107773630"
"121060","유니포인트","1700","1745","45","2.65","54690","95889485"
"048430","유라테크","6900","7350","450","6.52","437620","3185285860"
"206650","유바이오로직스","15750","17100","1350","8.57","9744660","164615960600"
"089850","유비벨록스","14650","16200","1550","10.58","2072094","33028330450"
"084440","유비온","2235","2295","60","2.68","135739","306649820"
"032620","유비케어","5360","6100","740","13.81","9939626","61643350750"
"264450","유비쿼스","14850","17400","2550","17.17","471157","7601029150"
"078070","유비쿼스홀딩스","16600","16350","-250","-1.51","1051821","17478108750"
"002920","유성기업","2820","2970","150","5.32","279511","807212985"
"024800","유성티엔에스","2555","2710","155","6.07","863652","2219780125"
"000700","유수홀딩스","5920","6130","210","3.55","391134","2347047420"
"054930","유신","27250","27300","50","0.18","4308861","115049421150"
"069330","유아이디","2060","2225","165","8.01","2078841","4576066770"
"049520","유아이엘","2550","3070","520","20.39","520881","1483798775"
"367460","유안타제7호스팩","2480","2165","-315","-12.70","8867173","21307138275"
"367480","유안타제8호스팩","2150","2150","0","0.00","493678","1064511235"
"003470","유안타증권","2675","2940","265","9.91","2347564","6485756630"
"003475","유안타증권우","2880","3235","355","12.33","90598","271998880"
"263770","유에스티","3025","3315","290","9.59","391291","1222133975"
"337840","유엑스엔","17400","19600","2200","12.64","58370","1060326850"
"072130","유엔젤","3180","3415","235","7.39","962869","3216909265"
"000220","유유제약","6470","6760","290","4.48","4750635","32803437760"
"000225","유유제약1우","8700","9420","720","8.28","1328868","12891174990"
"000227","유유제약2우B","17000","17250","250","1.47","22410","398754350"
"388720","유일로보틱스","21100","28450","7350","34.83","53290438","1438399913050"
"340930","유일에너테크","13250","15150","1900","14.34","1892236","28542705200"
"023410","유진기업","3905","4105","200","5.12","4120964","16147127135"
"056080","유진로봇","5020","5380","360","7.17","9048485","48028784015"
"373340","유진스팩6호","2265","2250","-15","-0.66","832091","1951605220"
"388800","유진스팩7호","2180","2155","-25","-1.15","189087","409599230"
"413630","유진스팩8호","2115","2120","5","0.24","199534","422941580"
"084370","유진테크","29650","28650","-1000","-3.37","2649971","79270850888"
"001200","유진투자증권","2640","2930","290","10.98","3036364","8535584940"
"178780","유테크","1730","1730","0","0.00","0","0"
"221800","유투바이오","28750","29000","250","0.87","1698","43481400"
"179900","유티아이","17500","23000","5500","31.43","3374743","77172410850"
"263050","유틸렉스","6700","5280","-1420","-21.19","33054525","179736686900"
"000100","유한양행","57300","59100","1800","3.14","3082085","177616397100"
"000105","유한양행우","55200","56800","1600","2.90","9963","559188800"
"003460","유화증권","2340","2500","160","6.84","232688","552739530"
"003465","유화증권우","2535","2590","55","2.17","10556","27511205"
"191410","육일씨엔에쓰","3180","3470","290","9.12","711887","2438943085"
"008730","율촌화학","19000","26150","7150","37.63","2369468","50480308900"
"072770","율호","1385","1615","230","16.61","8941931","13366530165"
"008250","이건산업","8690","9490","800","9.21","978324","8649876410"
"039020","이건홀딩스","3910","3960","50","1.28","3842969","14633226010"
"025820","이구산업","2985","3320","335","11.22","4206851","13021261465"
"067920","이글루","5320","5710","390","7.33","1368961","7961790650"
"044960","이글벳","6200","6720","520","8.39","11526163","76790410250"
"303530","이노뎁","14600","14050","-550","-3.77","980406","14644080100"
"302430","이노메트리","9550","12000","2450","25.65","400945","4385624450"
"279060","이노벡스","4665","4870","205","4.39","65255","309349650"
"214320","이노션","45850","43350","-2500","-5.45","2666942","120350173750"
"056090","이노시스","2220","4570","2350","105.86","62777762","666025346335"
"073490","이노와이어리스","28000","29750","1750","6.25","861302","25118571350"
"215790","이노인스트루먼트","1665","1700","35","2.10","1645600","2736546240"
"344860","이노진","7000","7390","390","5.57","7996","56083140"
"246960","이노테라피","9150","9510","360","3.93","56681","528750790"
"088390","이녹스","21200","25150","3950","18.63","1773957","42898138200"
"272290","이녹스첨단소재","34050","33500","-550","-1.62","6872901","236690319250"
"053350","이니텍","3930","4195","265","6.74","2449653","10658137565"
"041520","이라이콤","5410","5810","400","7.39","481904","2670235730"
"264850","이랜시스","2925","3265","340","11.62","14978259","51128498580"
"054210","이랜텍","18950","19450","500","2.64","8819052","171353585650"
"164060","이루다","5320","5830","510","9.59","5999105","33661704925"
"065440","이루온","2410","3235","825","34.23","230643293","684659061480"
"088260","이리츠코크렙","5780","5820","40","0.69","1268722","7106699590"
"139480","이마트","106500","108000","1500","1.41","4560039","492961590850"
"115610","이미지스","2565","2610","45","1.75","2079282","5414495515"
"349720","이베스트스팩5호","2100","2105","5","0.24","115647","242657010"
"078020","이베스트투자증권","6470","6810","340","5.26","1128771","7420008290"
"131400","이브이첨단소재","1895","1795","-100","-5.28","40264867","76532408745"
"208850","이비테크","6060","5990","-70","-1.16","3226","17878630"
"351330","이삭엔지니어링","11100","11600","500","4.50","1048957","12163590600"
"080010","이상네트웍스","5490","5780","290","5.28","1194400","6629392430"
"379390","이성씨엔아이","12050","11800","-250","-2.07","328","3350550"
"086890","이수앱지스","8190","8260","70","0.85","14462741","124788353170"
"007660","이수페타시스","6870","6970","100","1.46","25507596","186412505790"
"005950","이수화학","14500","16200","1700","11.72","6655313","101160543000"
"015020","이스타코","1275","1495","220","17.25","39235945","57425365975"
"047560","이스트소프트","9680","9950","270","2.79","1075889","10626530740"
"900110","이스트아시아홀딩스","225","228","3","1.33","93096469","21196556464"
"067010","이씨에스","3870","4180","310","8.01","13988206","65588414145"
"093230","이아이디","1280","1510","230","17.97","29768598","43577556555"
"341310","이앤에치","1700","1695","-5","-0.29","48590","75624610"
"101360","이엔드디","23350","28100","4750","20.34","2088393","56261919500"
"102710","이엔에프테크놀로지","27650","29300","1650","5.97","1130390","32209981600"
"066980","이엔코퍼레이션","2915","3240","325","11.15","6697735","21191155355"
"074610","이엔플러스","3075","3170","95","3.09","13029760","42405058805"
"063760","이엘피","5340","5350","10","0.19","990039","5366457180"
"123570","이엠넷","5340","6180","840","15.73","1630810","9325038220"
"083470","이엠앤아이","3220","3220","0","0.00","0","0"
"095190","이엠코리아","2855","3300","445","15.59","4528144","14224430775"
"091120","이엠텍","27150","27050","-100","-0.37","1390864","39114602200"
"232530","이엠티","3050","4480","1430","46.89","59481","154934820"
"102460","이연제약","23250","27350","4100","17.63","8366311","228325282050"
"039030","이오테크닉스","77800","78600","800","1.03","1609463","124782204300"
"294090","이오플로우","19350","20550","1200","6.20","1629110","32205560200"
"088290","이원컴포텍","8640","9120","480","5.56","2754615","23697916510"
"084680","이월드","1795","1995","200","11.14","33960197","69482518180"
"181340","이즈미디어","2705","2705","0","0.00","0","0"
"353810","이지바이오","4350","4530","180","4.14","26458184","122750833805"
"350520","이지스레지던스리츠","4870","4660","-210","-4.31","1400095","6400217460"
"334890","이지스밸류리츠","5140","5050","-90","-1.75","1349811","6669194700"
"099750","이지케어텍","24500","24950","450","1.84","414532","10606855050"
"377330","이지트로닉스","13350","15600","2250","16.85","8022884","123364207150"
"035810","이지홀딩스","3650","3660","10","0.27","15766716","57176311205"
"160600","이큐셀","3100","3100","0","0.00","0","0"
"092130","이크레더블","17100","17150","50","0.29","154530","2620123650"
"096040","이트론","183","200","17","9.29","278294769","54246939900"
"134060","이퓨쳐","6480","6450","-30","-0.46","340984","2298134640"
"001840","이화공영","5880","6620","740","12.59","9685118","63091544130"
"000760","이화산업","15000","15950","950","6.33","23088","358373550"
"024810","이화전기","1130","960","-170","-15.04","63153701","62379203263"
"014990","인디에프","780","777","-3","-0.38","1029248","786602606"
"041830","인바디","23100","25850","2750","11.90","679822","16817108250"
"352940","인바이오","5300","6010","710","13.40","612557","3566351120"
"101140","인바이오젠","1830","2185","355","19.40","18493853","42959276680"
"216400","인바이츠바이오코아","8800","8900","100","1.14","6886","60962280"
"079950","인베니아","2005","2095","90","4.49","1806182","3820719590"
"277410","인산가","2010","2155","145","7.21","2364855","4914654995"
"060150","인선이엔티","8490","9670","1180","13.90","14113753","138075171960"
"033230","인성정보","2185","2330","145","6.64","24839048","60584678820"
"006490","인스코비","2195","2110","-85","-3.87","11980853","25548325630"
"037330","인지디스플레","1830","2005","175","9.56","981288","1873155325"
"023800","인지컨트롤스","7260","8280","1020","14.05","1919676","15483968310"
"034590","인천도시가스","25000","27650","2650","10.60","1095059","31553205650"
"211050","인카금융서비스","7950","7580","-370","-4.65","2152885","15638146910"
"083640","인콘","1055","1325","270","25.59","207924074","327290237649"
"216050","인크로스","17700","16350","-1350","-7.63","1655054","26252741150"
"049070","인탑스","28000","31700","3700","13.21","9623176","297054985800"
"119610","인터로조","26750","28800","2050","7.66","1285374","36355474500"
"017250","인터엠","1210","1290","80","6.61","1446520","1867272175"
"129260","인터지스","2810","3010","200","7.12","1776710","5096528475"
"051370","인터플렉스","12700","12650","-50","-0.39","2066375","26619838250"
"064290","인텍플러스","19200","18250","-950","-4.95","2808259","52908376700"
"189300","인텔리안테크","62600","69500","6900","11.02","971715","63798080900"
"150840","인트로메딕","5850","5850","0","0.00","0","0"
"048530","인트론바이오","10450","12500","2050","19.62","8597097","97561593100"
"023810","인팩","8580","8900","320","3.73","473332","4210161320"
"175140","인포마크","7040","6980","-60","-0.85","278814","2021931830"
"115310","인포바인","30300","37250","6950","22.94","8860567","324394957950"
"039290","인포뱅크","13750","14850","1100","8.00","5205317","75900427550"
"071200","인피니트헬스케어","5110","5960","850","16.63","7556582","45820145830"
"101930","인화정공","13750","14950","1200","8.73","578682","8076611800"
"249420","일동제약","33200","39850","6650","20.03","107175750","4662891663100"
"000230","일동홀딩스","25850","31950","6100","23.60","35510113","1114563368800"
"013360","일성건설","3590","4100","510","14.21","31735554","124722205450"
"003120","일성신약","77000","77600","600","0.78","11173","866530100"
"333430","일승","3240","3995","755","23.30","33836808","124951548110"
"068330","일신바이오","3430","3430","0","0.00","0","0"
"003200","일신방직","95500","105000","9500","9.95","108279","10941896900"
"007110","일신석재","1400","1560","160","11.43","10810742","16105987225"
"058450","일야","604","654","50","8.28","6476687","4050668478"
"007570","일양약품","23250","24000","750","3.23","1888843","45641915400"
"007575","일양약품우","25650","25550","-100","-0.39","34445","910542250"
"008500","일정실업","18400","24100","5700","30.98","154487","3359023600"
"019540","일지테크","2475","2785","310","12.53","526688","1363881875"
"081000","일진다이아","19300","22850","3550","18.39","657345","13554679950"
"020760","일진디스플","2135","1990","-145","-6.79","17904530","39411556425"
"020150","일진머티리얼즈","69300","75500","6200","8.95","5956893","428600312300"
"103590","일진전기","6950","5950","-1000","-14.39","18322292","120778833930"
"094820","일진파워","16700","19150","2450","14.67","9681220","167462224450"
"271940","일진하이솔루스","32000","38000","6000","18.75","1680810","57100289950"
"015860","일진홀딩스","6250","6120","-130","-2.08","30913573","206154262410"
"226320","잇츠한불","16250","16600","350","2.15","613879","9964014100"
"950140","잉글우드랩","4810","4785","-25","-0.52","4655485","24123379675"
"049550","잉크테크","6780","6820","40","0.59","309737","2083607690"
"254120","자비스","1795","1865","70","3.90","8212354","15487816890"
"043910","자연과환경","1445","1740","295","20.42","138660646","220739834940"
"234920","자이글","2910","2780","-130","-4.47","260455","708754570"
"289220","자이언트스텝","22950","27500","4550","19.83","11994765","322231673900"
"317400","자이에스앤디","5940","8010","2070","34.85","21939875","181394241360"
"033240","자화전자","23900","24400","500","2.09","6320189","161250872350"
"174880","장원테크","1650","1650","0","0.00","1158396","1941775885"
"049630","재영솔루텍","698","786","88","12.61","4361419","3355604190"
"000950","전방","55500","54100","-1400","-2.52","27246","1514406600"
"110020","전진바이오팜","4480","3985","-495","-11.05","415648","1834626505"
"208140","정다운","2285","2405","120","5.25","3182134","7460806275"
"040420","정상제이엘에스","7460","7600","140","1.88","255008","1907074360"
"045510","정원엔시스","1965","2230","265","13.49","141341088","321328001015"
"217190","제너셈","6230","6260","30","0.48","359935","2225624730"
"095700","제넥신","32900","33400","500","1.52","2489191","82496365050"
"072520","제넨바이오","2290","2205","-85","-3.71","13281557","33650338065"
"122310","제노레이","8070","8980","910","11.28","1868245","16717903550"
"361390","제노코","21400","26200","4800","22.43","3508764","84429461500"
"066830","제노텍","3595","3000","-595","-16.55","11562","35839725"
"187420","제노포커스","5570","6600","1030","18.49","26856278","200130569090"
"225220","제놀루션","12350","12700","350","2.83","5429703","75805138650"
"123330","제닉","3970","5070","1100","27.71","19208116","103712118060"
"159580","제로투세븐","6890","7240","350","5.08","3191098","22478529810"
"147830","제룡산업","2990","3130","140","4.68","1892884","5685905700"
"033100","제룡전기","6980","7390","410","5.87","14609487","107847123460"
"079370","제우스","22900","22800","-100","-0.44","3024610","70696370350"
"054950","제이브이엠","17000","21650","4650","27.35","3367530","66829095650"
"023440","제이스코홀딩스","2350","1995","-355","-15.11","3497139","7826791085"
"090470","제이스텍","5720","6820","1100","19.23","2931944","19334246570"
"287410","제이시스메디칼","7340","7950","610","8.31","9565001","73336059540"
"137950","제이씨케미칼","7820","8560","740","9.46","16149212","139793725970"
"033320","제이씨현시스템","4905","5270","365","7.44","1523667","8014455580"
"348950","제이알글로벌리츠","4505","4685","180","4.00","16022446","72160216160"
"204270","제이앤티씨","5040","5190","150","2.98","389817","2019221980"
"194370","제이에스코퍼레이션","17500","17350","-150","-0.86","1645687","28153309000"
"026040","제이에스티나","2995","3050","55","1.84","840552","2449912820"
"126880","제이엔케이히터","5530","6090","560","10.13","7989215","46882381100"
"322510","제이엘케이","4695","5110","415","8.84","414904","2030595755"
"254160","제이엠멀티","5490","4370","-1120","-20.40","10510","45596420"
"033050","제이엠아이","1100","1150","50","4.55","2613255","2947732455"
"094970","제이엠티","3310","3625","315","9.52","1758010","6130292045"
"058420","제이웨이","2160","2160","0","0.00","0","0"
"025620","제이준코스메틱","972","905","-67","-6.89","10049655","9698494310"
"089790","제이티","6660","7040","380","5.71","2303105","16778280240"
"030000","제일기획","23550","22400","-1150","-4.88","6982855","156458911098"
"052670","제일바이오","1875","1870","-5","-0.27","1430077","2644636465"
"271980","제일약품","21150","23000","1850","8.75","2216748","54828612500"
"001560","제일연마","9060","9390","330","3.64","854786","7894668340"
"199820","제일전기공업","11950","12550","600","5.02","278916","3303025750"
"038010","제일테크노스","7070","7850","780","11.03","3718642","26346166090"
"002620","제일파마홀딩스","12050","13300","1250","10.37","625232","8428801900"
"276730","제주맥주","2170","2415","245","11.29","28251327","68103945375"
"080220","제주반도체","4210","4840","630","14.96","40993287","198392480670"
"006220","제주은행","4395","5310","915","20.82","27888824","166418803825"
"089590","제주항공","15700","15350","-350","-2.23","4333200","65441857391"
"216080","제테마","13800","15700","1900","13.77","501795","7431687350"
"229000","젠큐릭스","9280","9700","420","4.53","590840","5772220790"
"248020","젬","2500","2500","0","0.00","0","0"
"082270","젬백스","13050","15200","2150","16.48","3041263","42038402450"
"064800","젬백스링크","1310","1395","85","6.49","8281024","11329404130"
"044060","조광ILI","2441","1575","-866","-35.48","157500767","530883238605"
"004910","조광페인트","6100","8010","1910","31.31","1717006","12270912840"
"004700","조광피혁","42800","44700","1900","4.44","12833","559494200"
"001550","조비","19500","20800","1300","6.67","812675","15919343500"
"000480","조선내화","79400","77600","-1800","-2.27","22639","1755853600"
"120030","조선선재","152500","160500","8000","5.25","3624765","578157130500"
"034940","조아제약","2875","2940","65","2.26","3206014","9610470490"
"067000","조이시티","4770","5140","370","7.76","34161007","180028242085"
"018470","조일알미늄","1615","2230","615","38.08","205446562","446325761235"
"002600","조흥","174000","183000","9000","5.17","1282","226772500"
"185750","종근당","88800","91100","2300","2.59","406039","36717980800"
"063160","종근당바이오","28800","30400","1600","5.56","539958","16437888550"
"001630","종근당홀딩스","56400","61000","4600","8.16","86160","5053211000"
"033340","좋은사람들","1055","1055","0","0.00","0","0"
"036930","주성엔지니어링","16650","15850","-800","-4.80","20803934","344778696950"
"044380","주연테크","818","890","72","8.80","3799242","3323393316"
"239340","줌인터넷","4005","4305","300","7.49","13062219","57369954565"
"051980","중앙디앤엠","712","698","-14","-1.97","5341067","3911145306"
"072020","중앙백신","12150","12700","550","4.53","337178","4247480700"
"000440","중앙에너비스","21550","21250","-300","-1.39","1556270","33205804350"
"078650","지나인제약","2120","2120","0","0.00","0","0"
"228760","지노믹트리","13350","13150","-200","-1.50","2522494","34039116950"
"314130","지놈앤컴퍼니","18000","21350","3350","18.61","2458914","50785936000"
"013890","지누스","50200","47700","-2500","-4.98","1087717","51515370050"
"389030","지니너스","4103","2940","-1163","-28.35","23551468","110596158770"
"043610","지니뮤직","4100","4480","380","9.27","30062956","147698860695"
"263860","지니언스","7950","9040","1090","13.71","593103","5138513810"
"303030","지니틱스","2320","2635","315","13.58","18524716","47880436505"
"036180","지더블유바이텍","782","877","95","12.15","125245872","143817553063"
"208350","지란지교시큐리티","3835","3930","95","2.48","183532","709913240"
"144510","지씨셀","59200","65500","6300","10.64","2713532","175072861100"
"382480","지아이텍","3005","3450","445","14.81","8928309","28999781620"
"382800","지앤비에스엔지니어링","11650","12100","450","3.86","669140","8088432900"
"299480","지앤이헬스케어","899","896","-3","-0.33","1331","1164102"
"051160","지어소프트","12200","12650","450","3.69","1408134","17095310100"
"053050","지에스이","4565","5280","715","15.66","95815711","494108003740"
"119850","지엔씨에너지","4320","4525","205","4.75","14424980","66702420255"
"270520","지엔원에너지","2565","2740","175","6.82","11841529","32913933405"
"065060","지엔코","567","573","6","1.06","2457366","1395753625"
"204840","지엘팜텍","896","957","61","6.81","10630939","10423700239"
"013870","지엠비코리아","5480","5890","410","7.48","646347","3617002400"
"071320","지역난방공사","31100","33250","2150","6.91","42327","1351166250"
"311320","지오엘리먼트","18200","20050","1850","10.16","2213039","44847896100"
"035000","지투알","5800","6000","200","3.45","152205","909234970"
"388050","지투파워","7388","15500","8112","109.80","26505375","1179784882900"
"219750","지티지웰니스","1425","1425","0","0.00","0","0"
"088790","진도","2920","3335","415","14.21","1085741","3521038155"
"018120","진로발효","23550","24150","600","2.55","112808","2716727850"
"109820","진매트릭스","7830","7680","-150","-1.92","70220899","621764534250"
"086060","진바이오텍","4825","4905","80","1.66","1197852","5784524185"
"036890","진성티이씨","10200","10350","150","1.47","4544206","47144541540"
"363250","진시스템","10150","9800","-350","-3.45","529503","5454607090"
"003780","진양산업","7340","7670","330","4.50","1353604","10107385680"
"007370","진양제약","5990","6170","180","3.01","484980","3009470250"
"010640","진양폴리","5760","6330","570","9.90","1663013","10093372840"
"100250","진양홀딩스","3635","3575","-60","-1.65","858846","3067706455"
"051630","진양화학","3800","3995","195","5.13","776006","2956646155"
"272450","진에어","14550","14800","250","1.72","4245798","60165166000"
"011000","진원생명과학","11150","13250","2100","18.83","70987099","1029476522650"
"250030","진코스텍","4250","4395","145","3.41","25453","102904630"
"002780","진흥기업","1695","1815","120","7.08","23700270","40517066690"
"002787","진흥기업2우B","14900","14900","0","0.00","13517","194553300"
"002785","진흥기업우B","5430","5610","180","3.31","28350","151565130"
"233990","질경이","799","689","-110","-13.77","81968","56912881"
"085660","차바이오텍","15000","16800","1800","12.00","5167455","81771265000"
"261780","차백신연구소","6390","7530","1140","17.84","74676597","595892802230"
"009310","참엔지니어링","837","847","10","1.19","2915629","2416658946"
"158310","참존글로벌","1680","1680","0","0.00","0","0"
"094850","참좋은여행","9700","10100","400","4.12","1275814","12268805430"
"004650","창해에탄올","12000","12900","900","7.50","1808518","22987358200"
"278280","천보","216100","254500","38400","17.77","1204610","281837887700"
"000650","천일고속","63400","66000","2600","4.10","6010","390645600"
"140290","청광건설","592","597","5","0.84","5598","3017261"
"362320","청담글로벌","9150","10650","1500","16.39","90437792","932446911810"
"066360","체리부로","1180","1195","15","1.27","512425","604956785"
"033250","체시스","1030","1110","80","7.77","3036014","3163321262"
"047820","초록뱀미디어","15500","17250","1750","11.29","2870570","46793452750"
"052300","초록뱀컴퍼니","820","891","71","8.66","104776271","102974591642"
"118000","초록뱀헬스케어","974","941","-33","-3.39","13585188","13670355359"
"094360","칩스앤미디어","15400","19050","3650","23.70","2761607","47578221200"
"016790","카나리아바이오","35000","34700","-300","-0.86","42965752","1753916939950"
"016920","카스","2320","2460","140","6.03","34090389","88806759755"
"284620","카이노스메드","9353","7190","-2163","-23.13","2694471","21659628430"
"035720","카카오","71800","84100","12300","17.13","39066456","2957221987376"
"293490","카카오게임즈","49000","60400","11400","23.27","22875033","1244599567700"
"323410","카카오뱅크","31300","32200","900","2.88","31449058","982537834900"
"377300","카카오페이","65300","74800","9500","14.55","11714559","798789118800"
"042000","카페24","12500","13400","900","7.20","1465105","18877629100"
"006380","카프로","2880","3020","140","4.86","1648728","4742393290"
"317530","캐리소프트","6360","6380","20","0.31","1958806","14452833440"
"071850","캐스텍코리아","1920","2120","200","10.42","558476","1115521465"
"050110","캠시스","2300","2720","420","18.26","426963449","1117927967470"
"223310","커머스마이너","3320","3320","0","0.00","0","0"
"109070","컨버즈","4100","4100","0","0.00","0","0"
"900310","컬러레이","1010","1055","45","4.46","5868476","5886711977"
"078340","컴투스","75100","86500","11400","15.18","3539277","282489537300"
"063080","컴투스홀딩스","53600","63600","10000","18.66","5207907","309449719300"
"307930","컴퍼니케이","6050","6390","340","5.62","1065982","6738056340"
"079190","케스피온","1275","1370","95","7.45","4340790","5817346915"
"263700","케어랩스","6220","6710","490","7.88","4020816","28358062920"
"214370","케어젠","99600","143500","43900","44.08","2197769","277658826300"
"221980","케이디켐","14250","14700","450","3.16","1264842","19480500500"
"001620","케이비아이동국실업","603","673","70","11.61","1816300","1166895202"
"342550","케이비제20호스팩","2290","2290","0","0.00","0","0"
"424140","케이비제21호스팩","2105","2110","5","0.24","604308","1274544795"
"192250","케이사인","1760","2045","285","16.19","49798905","101155342065"
"029460","케이씨","20000","17950","-2050","-10.25","660119","12439237350"
"115500","케이씨에스","6270","6800","530","8.45","11076439","77816104090"
"281820","케이씨텍","17900","16400","-1500","-8.38","594529","10259039700"
"089150","케이씨티","5550","5730","180","3.24","5692831","32537524270"
"025880","케이씨피드","3795","3505","-290","-7.64","6417140","22709275285"
"093320","케이아이엔엑스","50000","57300","7300","14.60","254063","13858251250"
"073010","케이에스피","2160","2110","-50","-2.31","1513829","3133029415"
"105330","케이엔더블유","9170","10850","1680","18.32","779726","7788192790"
"272110","케이엔제이","11400","11050","-350","-3.07","378815","4196249350"
"039420","케이엘넷","2830","3000","170","6.01","5382871","16620093615"
"083550","케이엠","6410","7360","950","14.82","9621994","75773011620"
"032500","케이엠더블유","27150","31750","4600","16.94","3128754","96509498700"
"225430","케이엠제약","1570","1710","140","8.92","4266387","7564084420"
"102370","케이옥션","12300","7240","-5060","-41.14","24652001","225072194760"
"381970","케이카","20000","22450","2450","12.25","11569722","251336846400"
"145270","케이탑리츠","1075","1135","60","5.58","2728867","2901708010"
"036030","케이티알파","5290","6540","1250","23.63","31335592","209439256460"
"064820","케이프","4195","4745","550","13.11","8387678","41450229595"
"347140","케이프이에스제4호","2120","2100","-20","-0.94","81904","172205975"
"256940","케이피에스","5710","6270","560","9.81","679592","4252205840"
"024880","케이피에프","7130","9510","2380","33.38","73397923","626304087520"
"042040","케이피엠테크","582","546","-36","-6.19","32866774","18313590178"
"054410","케이피티유","5750","6030","280","4.87","189600","1119591540"
"258610","케일럼","4670","4340","-330","-7.07","1559936","6582387030"
"274090","켄코아에어로스페이스","10700","11550","850","7.94","1183915","13327972600"
"402420","켈스","14950","14800","-150","-1.00","1364","18965200"
"217600","켐온","2765","2875","110","3.98","81344675","247092782075"
"089010","켐트로닉스","19000","21900","2900","15.26","1011155","20709083000"
"220260","켐트로스","6940","10100","3160","45.53","36381881","345089898430"
"176590","코나솔","5340","6190","850","15.92","72780","445938750"
"052400","코나아이","17000","18000","1000","5.88","1269531","22036269800"
"402030","코난테크놀로지","35500","25800","-9700","-27.32","8507860","260710598500"
"391710","코닉오토메이션","2690","4395","1705","63.38","45509680","169275787065"
"046070","코다코","1270","1315","45","3.54","1874573","2463231615"
"047770","코데즈컴바인","1860","2295","435","23.39","123801839","301322278265"
"078940","코드네이처","1665","1450","-215","-12.91","1731566","2590881125"
"080530","코디","1400","1555","155","11.07","1361274","2115037455"
"224060","코디엠","865","864","-1","-0.12","14784116","3051319501"
"417310","코람코더원리츠","5470","5390","-80","-1.46","848349","4433345940"
"357120","코람코에너지리츠","5800","5560","-240","-4.14","2585736","14249860590"
"104540","코렌텍","10350","10700","350","3.38","877159","8975591000"
"027050","코리아나","2950","3030","80","2.71","2215145","6593129915"
"290510","코리아센터","5040","5640","600","11.90","3984815","21230285800"
"007815","코리아써우","8010","8100","90","1.12","52057","424897050"
"007810","코리아써키트","19200","18700","-500","-2.60","5297624","105248049950"
"00781K","코리아써키트2우B","8550","8600","50","0.58","9785","83756180"
"190650","코리아에셋투자증권","9650","9930","280","2.90","2308923","24452176920"
"101670","코리아에스이","2055","2270","215","10.46","5576360","12139181340"
"123410","코리아에프티","2795","2915","120","4.29","4126460","11777192485"
"003690","코리안리","8510","8680","170","2.00","2620859","22903251690"
"036690","코맥스","3515","3795","280","7.97","649009","2344400985"
"049430","코메론","8920","9430","510","5.72","425350","3936014350"
"183300","코미코","47600","45700","-1900","-3.99","774504","36823418400"
"041960","코미팜","7190","7930","740","10.29","1945187","14098099490"
"089890","코세스","8620","10100","1480","17.17","4529658","44954533880"
"009730","코센","2715","2715","0","0.00","0","0"
"189350","코셋","2245","2185","-60","-2.67","4642","8602665"
"082660","코스나인","965","994","29","3.01","11719180","12102719772"
"192820","코스맥스","61700","67300","5600","9.08","2152606","146269545850"
"044820","코스맥스비티아이","9710","9420","-290","-2.99","551845","5165266840"
"222040","코스맥스엔비티","4480","5010","530","11.83","1590475","7642467930"
"241710","코스메카코리아","9730","9740","10","0.10","411327","4004046720"
"005070","코스모신소재","49650","62600","12950","26.08","18150398","1009788549800"
"005420","코스모화학","14650","22400","7750","52.90","49938281","940145750950"
"069110","코스온","2630","2630","0","0.00","0","0"
"169670","코스텍시스템","9600","11500","1900","19.79","126017","1369505150"
"071950","코아스","995","987","-8","-0.80","1428187","1383738549"
"166480","코아스템","10800","11150","350","3.24","606589","7038897800"
"045970","코아시아","6350","7400","1050","16.54","4376569","31638543450"
"196450","코아시아옵틱스","2000","1915","-85","-4.25","3132369","5956472105"
"029960","코엔텍","8210","8670","460","5.60","7612911","67133483740"
"002020","코오롱","22850","25750","2900","12.69","598480","14638200150"
"003070","코오롱글로벌","15800","18600","2800","17.72","3309912","63684435750"
"003075","코오롱글로벌우","27950","30350","2400","8.59","114138","3736496100"
"102940","코오롱생명과학","32800","39950","7150","21.80","881136","32748727550"
"002025","코오롱우","16100","17000","900","5.59","778589","15315117500"
"120110","코오롱인더","51700","54300","2600","5.03","2958106","154828965950"
"120115","코오롱인더우","27050","28500","1450","5.36","110131","3091378350"
"950160","코오롱티슈진","8010","8010","0","0.00","0","0"
"138490","코오롱플라스틱","10550","11900","1350","12.80","5644161","63489103280"
"056000","코원플레이","2860","2860","0","0.00","0","0"
"021240","코웨이","64900","64500","-400","-0.62","2420562","155003679600"
"033290","코웰패션","6200","6740","540","8.71","2538666","16373823690"
"056360","코위버","7010","7290","280","3.99","712020","4974283710"
"282880","코윈테크","24400","28450","4050","16.60","1412398","38023928150"
"121850","코이즈","3130","3830","700","22.36","42997699","160732660820"
"015710","코콤","4955","5170","215","4.34","338063","1718807125"
"052330","코텍","8620","9720","1100","12.76","1287226","12095685310"
"322780","코퍼스코리아","2365","2745","380","16.07","33056699","88994565425"
"126600","코프라","6420","6460","40","0.62","16567857","114085770870"
"036420","콘텐트리중앙","35750","41850","6100","17.06","3533712","132405215500"
"200130","콜마비앤에이치","26700","27650","950","3.56","1344064","36192989200"
"031820","콤텍시스템","770","861","91","11.82","9858355","7944444247"
"294570","쿠콘","32800","35050","2250","6.86","899464","30123301350"
"192400","쿠쿠홀딩스","15900","17000","1100","6.92","873196","14393482350"
"284740","쿠쿠홈시스","28150","31200","3050","10.83","381486","11384096950"
"317690","퀀타매트릭스","6010","6530","520","8.65","2823114","18991912020"
"365270","큐라클","19200","17750","-1450","-7.55","4326098","81086730400"
"060280","큐렉소","7430","8070","640","8.61","1175534","9335050500"
"015590","큐로","390","412","22","5.64","5465188","2216277074"
"040350","큐로컴","1105","1115","10","0.90","7047331","8317968580"
"051780","큐로홀딩스","500","502","2","0.40","4930113","2471136495"
"115180","큐리언트","30300","30300","0","0.00","0","0"
"182360","큐브엔터","13150","13800","650","4.94","1984176","27496753000"
"066310","큐에스아이","12100","12750","650","5.37","2503494","31036015600"
"136660","큐엠씨","2060","2590","530","25.73","9132","19006200"
"016600","큐캐피탈","567","555","-12","-2.12","22805403","12693867867"
"264900","크라운제과","8600","9770","1170","13.60","5003415","51973077400"
"26490K","크라운제과우","11000","12400","1400","12.73","1035428","13614095300"
"005740","크라운해태홀딩스","7110","7530","420","5.91","3536440","30067973530"
"005745","크라운해태홀딩스우","11450","11700","250","2.18","129854","1631528950"
"259960","크래프톤","237000","259000","22000","9.28","3968178","977222701000"
"096240","크레버스","23850","24400","550","2.31","426480","10483702950"
"215570","크로넥스","3200","2750","-450","-14.06","74295","198304770"
"043590","크로바하이텍","1515","1800","285","18.81","7242700","11726820565"
"114120","크루셜텍","1085","1085","0","0.00","0","0"
"110790","크리스에프앤씨","35500","35050","-450","-1.27","589180","20470758150"
"900250","크리스탈신소재","988","1135","147","14.88","80489303","90956968139"
"083790","크리스탈지노믹스","4190","4060","-130","-3.10","3425618","14323757050"
"045520","크린앤사이언스","10150","10350","200","1.97","210115","2209748350"
"036170","클라우드에어","1095","1240","145","13.24","14299266","18090294065"
"214150","클래시스","14500","15550","1050","7.24","6493911","102197897600"
"352770","클리노믹스","7700","8320","620","8.05","2812459","25353456230"
"237880","클리오","14400","14750","350","2.43","1209519","17442758650"
"139670","키네마스터","9290","11050","1760","18.95","5042971","58440973720"
"020120","키다리스튜디오","8260","10200","1940","23.49","28731321","290803978390"
"413600","키움제6호스팩","2275","2175","-100","-4.40","1339611","3002023305"
"039490","키움증권","79600","89200","9600","12.06","1558726","123677194700"
"054780","키이스트","7660","8680","1020","13.32","1188583","9848775400"
"336040","타스컴","19700","18600","-1100","-5.58","2262","42064700"
"219130","타이거일렉","16200","15850","-350","-2.16","727086","11456348250"
"318660","타임기술","2295","1740","-555","-24.18","54480","84223895"
"180060","탑선","13150","12400","-750","-5.70","132195","1626843100"
"065130","탑엔지니어링","5600","6100","500","8.93","441783","2691156990"
"134580","탑코미디어","7350","8880","1530","20.82","1675649","13621545670"
"014580","태경비케이","4125","4520","395","9.58","2671417","11352136825"
"015890","태경산업","6180","6650","470","7.61","7291543","49032432720"
"006890","태경케미컬","14350","13350","-1000","-6.97","6395434","91980475500"
"023160","태광","13050","16600","3550","27.20","10520479","153320226950"
"003240","태광산업","906000","886000","-20000","-2.21","6899","6146407000"
"011280","태림포장","3105","3340","235","7.57","2347410","7802071595"
"323280","태성","1890","1730","-160","-8.47","10694216","19274361310"
"053620","태양","8290","9060","770","9.29","1133366","10085382010"
"004100","태양금속","1415","1410","-5","-0.35","3826783","5240448930"
"004105","태양금속우","2525","2520","-5","-0.20","145020","360062310"
"116100","태양기계","1005","1000","-5","-0.50","15625","15003690"
"009410","태영건설","6760","7040","280","4.14","3676823","25780840290"
"009415","태영건설우","9700","11700","2000","20.62","1883806","22530862520"
"044490","태웅","9930","11150","1220","12.29","1464780","14857450200"
"124560","태웅로직스","5460","5170","-290","-5.31","11874758","60751252450"
"001420","태원물산","4950","5060","110","2.22","236792","1192730800"
"007980","태평양물산","1845","1815","-30","-1.63","1980230","3488343565"
"191420","테고사이언스","21700","20750","-950","-4.38","380932","8103917700"
"073640","테라사이언스","1855","1720","-135","-7.28","9525786","16918783165"
"182690","테라셈","1440","1440","0","0.00","0","0"
"066700","테라젠이텍스","4455","4865","410","9.20","5950684","29004930445"
"095610","테스","20000","20350","350","1.75","1930524","38928983400"
"055490","테이팩스","68600","80300","11700","17.06","466364","34336681600"
"308700","테크엔","726","695","-31","-4.27","6718","4170539"
"089030","테크윙","7544","8140","596","7.90","9412153","139813354740"
"258050","테크트랜스","1185","1200","15","1.27","30924","34857800"
"054450","텔레칩스","14400","15450","1050","7.29","4147739","64174922600"
"091440","텔레필드","4130","3935","-195","-4.72","1316233","5292988725"
"078000","텔코웨어","9470","9850","380","4.01","60552","581673520"
"200230","텔콘RF제약","1540","1505","-35","-2.27","7523714","11536524750"
"214420","토니모리","4220","4145","-75","-1.78","2614119","11080709440"
"393210","토마토시스템","11850","10700","-1150","-9.70","5588","61575130"
"215480","토박스코리아","4610","4905","295","6.40","745171","3541163075"
"051360","토비스","9100","9260","160","1.76","1662191","15214221480"
"045340","토탈소프트","6140","6380","240","3.91","11436814","77753913530"
"108230","톱텍","7240","7800","560","7.73","1108764","8200016370"
"079970","투비소프트","1080","965","-115","-10.65","4182990","4138642910"
"199800","툴젠","70500","68700","-1800","-2.55","644752","44889814400"
"105550","트루윈","2580","2755","175","6.78","28612740","84368605375"
"290090","트윔","16400","19100","2700","16.46","1122704","20777088000"
"026150","특수건설","8650","11400","2750","31.79","12945223","138569553910"
"322180","티라유텍","8810","9250","440","4.99","218039","1988923540"
"117730","티로보틱스","7090","7990","900","12.69","12306097","96614889020"
"033830","티비씨","989","1085","96","9.71","10920477","11419891174"
"057680","티사이언티픽","2415","3195","780","32.30","49783591","159887108100"
"064760","티씨케이","113700","117500","3800","3.34","683425","82087930750"
"246710","티앤알바이오팹","15500","19950","4450","28.71","7442984","144010228200"
"340570","티앤엘","33700","37350","3650","10.83","1542648","55293177000"
"043220","티에스넥스젠","1130","1185","55","4.87","10071260","11773185865"
"277880","티에스아이","9580","10550","970","10.13","1510499","15136371060"
"131290","티에스이","60700","57900","-2800","-4.61","3114857","188030959400"
"019180","티에이치엔","3040","3285","245","8.06","1146692","3621360985"
"356860","티엘비","37150","41000","3850","10.36","1431657","56680907200"
"062860","티엘아이","7000","7060","60","0.86","254562","1759256940"
"363280","티와이홀딩스","18400","18950","550","2.99","1198700","21921043650"
"36328K","티와이홀딩스우","16450","18300","1850","11.25","55430","928890200"
"321550","티움바이오","16350","16900","550","3.36","1629893","28642703800"
"091810","티웨이항공","1990","2030","40","2.01","8741033","17439561950"
"004870","티웨이홀딩스","545","540","-5","-0.92","4779502","2548057259"
"104480","티케이케미칼","4060","4440","380","9.36","8841922","36721195855"
"081150","티플랙스","4290","4825","535","12.47","40785426","192675165530"
"130740","티피씨글로벌","2900","3195","295","10.17","2754587","8594225430"
"217880","틸론","11000","12800","1800","16.36","31255","350068740"
"084730","팅크웨어","13750","17000","3250","23.64","4280785","67969374300"
"046210","파나진","3105","2970","-135","-4.35","987054","3082513130"
"058530","파나케이아","1620","1620","0","0.00","0","0"
"034230","파라다이스","13700","15000","1300","9.49","11463206","154048862650"
"033540","파라텍","1555","1345","-210","-13.50","25572229","36535811060"
"043200","파루","1030","1175","145","14.08","6326041","6920822053"
"214450","파마리서치","65600","69000","3400","5.18","1746166","118765407000"
"217950","파마리서치바이오","32850","34000","1150","3.50","10901","351517150"
"208340","파멥신","4190","3810","-380","-9.07","4640651","17830787480"
"005690","파미셀","12200","13500","1300","10.66","24836738","326624394650"
"177830","파버나인","3890","4145","255","6.56","1652548","6682556460"
"037070","파세코","16650","14050","-2600","-15.62","3478100","52919010950"
"150900","파수","8960","9750","790","8.82","546696","5080629500"
"037030","파워넷","3765","4460","695","18.46","18098169","79187771575"
"047310","파워로직스","5770","6500","730","12.65","7623903","48933704300"
"266870","파워풀엑스","1295","1300","5","0.39","17730","23911850"
"368770","파이버프로","3790","4330","540","14.25","9788961","40638848925"
"170790","파이오링크","10900","11650","750","6.88","183927","2089610050"
"049120","파인디앤씨","1795","1965","170","9.47","4495727","8829472590"
"038950","파인디지털","5460","6050","590","10.81","5604664","32704953780"
"106240","파인테크닉스","11150","11050","-100","-0.90","13006007","152169351050"
"131760","파인텍","1100","1210","110","10.00","4334582","5072281640"
"065690","파커스","2595","2790","195","7.51","281102","750224640"
"140860","파크시스템스","97500","97300","-200","-0.21","562910","54290896400"
"091700","파트론","8560","8730","170","1.99","10125873","85365544790"
"202960","판도라티비","1385","1885","500","36.10","65136","107257275"
"032800","판타지오","640","756","116","18.13","10950995","8412152579"
"318010","팜스빌","12500","13550","1050","8.40","438907","5631816050"
"036580","팜스코","4985","5320","335","6.72","2350724","11813733685"
"027710","팜스토리","2825","2435","-390","-13.81","44277418","115895730725"
"004720","팜젠사이언스","7640","7760","120","1.57","4925752","41230101860"
"225590","패션플랫폼","1440","1605","165","11.46","14591639","24399986665"
"054300","팬스타엔터프라이즈","727","744","17","2.34","3242394","2328314446"
"068050","팬엔터테인먼트","3380","3755","375","11.09","4012990","14890972720"
"028670","팬오션","5590","5690","100","1.79","53826599","295783949920"
"222110","팬젠","6610","7470","860","13.01","509575","3887452480"
"010820","퍼스텍","3350","3990","640","19.10","98465943","387403803105"
"016800","퍼시스","32950","31600","-1350","-4.10","87104","2771547100"
"263750","펄어비스","52600","59500","6900","13.12","8566470","473263112600"
"251970","펌텍코리아","14900","16250","1350","9.06","294345","4646450500"
"001020","페이퍼코리아","1840","1785","-55","-2.99","10345202","18028639625"
"327610","펨토바이오메드","13900","13600","-300","-2.16","19946","280726700"
"087010","펩트론","10250","9310","-940","-9.17","1601193","15547417810"
"090080","평화산업","1380","1715","335","24.28","88584716","161896894995"
"010770","평화홀딩스","3300","3730","430","13.03","5061837","20784473710"
"119500","포메탈","4710","5230","520","11.04","7191796","36682881310"
"389140","포바이포","21650","20050","-1600","-7.39","18844780","436717462300"
"022100","포스코 ICT","5260","6120","860","16.35","16070079","91187728215"
"058430","포스코스틸리온","33450","39950","6500","19.43","1580629","59535153600"
"009520","포스코엠텍","5520","7260","1740","31.52","82257580","557548485710"
"047050","포스코인터내셔널","18350","22400","4050","22.07","15592317","308603964900"
"003670","포스코케미칼","109000","160500","51500","47.25","15912804","2141410415500"
"189690","포시에스","7320","7240","-80","-1.09","551184","3917788670"
"318020","포인트모바일","18100","18100","0","0.00","0","0"
"256630","포인트엔지니어링","2700","2545","-155","-5.74","946832","2456119770"
"331380","포커스에이치엔에스","2490","2585","95","3.82","1079665","2775937755"
"234100","폴라리스세원","2085","2380","295","14.15","48357483","115959995630"
"041020","폴라리스오피스","1360","1550","190","13.97","4149331","6387007640"
"114630","폴라리스우노","4045","4440","395","9.77","15419502","73334398290"
"290720","푸드나무","20350","24500","4150","20.39","1282676","30288568900"
"005670","푸드웰","6200","6910","710","11.45","4368725","31161488100"
"094940","푸른기술","8150","8530","380","4.66","1912829","15986878840"
"007330","푸른저축은행","8670","10400","1730","19.95","6035875","64259142490"
"017810","풀무원","12550","14650","2100","16.73","1544730","20811098200"
"093380","풍강","4070","4325","255","6.27","721059","3029444170"
"023900","풍국주정","15100","15500","400","2.65","378759","5753367200"
"103140","풍산","24150","27800","3650","15.11","2572169","66981677500"
"005810","풍산홀딩스","25000","28000","3000","12.00","429667","11348191200"
"371950","풍원정밀","15300","13800","-1500","-9.80","1664438","24936752800"
"370090","퓨런티어","30700","27550","-3150","-10.26","9597537","270709841300"
"220100","퓨쳐켐","16950","16250","-700","-4.13","2153486","35091862400"
"035200","프럼파스트","4235","4695","460","10.86","8699572","40793594190"
"334970","프레스티지바이오로직스","4480","4705","225","5.02","16661043","82231532345"
"950210","프레스티지바이오파마","11750","11950","200","1.70","3524479","43818869300"
"203690","프로스테믹스","2370","2025","-345","-14.56","3758739","7819505360"
"321260","프로이천","2020","2320","300","14.85","13645830","31518834040"
"303360","프로테옴텍","4490","6350","1860","41.43","70212","400159700"
"053610","프로텍","22250","24750","2500","11.24","1111523","26524214300"
"377220","프롬바이오","8640","9950","1310","15.16","24862139","243487798050"
"335810","프리시젼바이오","7190","8080","890","12.38","2901105","24065816090"
"053160","프리엠스","9620","9040","-580","-6.03","1881617","17783825530"
"041590","플래스크","1515","2140","625","41.25","35883884","65032845280"
"367000","플래티어","12550","13300","750","5.98","776526","10088568200"
"075130","플랜티넷","2700","2980","280","10.37","1054786","2995337525"
"222670","플럼라인생명과학","5140","5130","-10","-0.19","6953","36326040"
"009810","플레이그램","1220","1080","-140","-11.48","31436644","43908311950"
"237820","플레이디","5340","5930","590","11.05","1256313","7531453840"
"023770","플레이위드","8620","8540","-80","-0.93","2468053","21177091080"
"300080","플리토","30400","40850","10450","34.38","400343","15045561350"
"150440","피노텍","994","994","0","0.00","0","0"
"032580","피델릭스","1450","1610","160","11.03","11133738","17785897685"
"051380","피씨디렉트","14750","13900","-850","-5.76","4983452","82013219750"
"241820","피씨엘","21800","18550","-3250","-14.91","2532346","58164266550"
"237750","피앤씨테크","7630","6750","-880","-11.53","5454917","39772322680"
"024850","피에스엠씨","1025","1020","-5","-0.49","2007779","2049389991"
"319660","피에스케이","38800","35500","-3300","-8.51","3625862","136627098550"
"031980","피에스케이홀딩스","9140","8870","-270","-2.95","1457365","13464908620"
"002230","피에스텍","4200","4075","-125","-2.98","216565","904636515"
"057880","피에이치씨","1740","1740","0","0.00","0","0"
"043370","피에이치에이","7160","7180","20","0.28","1523282","11744321930"
"242350","피엔아이컴퍼니","5520","6300","780","14.13","70081","406967500"
"239890","피엔에이치테크","17350","16750","-600","-3.46","1128976","19874812250"
"347740","피엔케이피부임상연구센타","3925","6830","2905","74.01","51891140","470522417515"
"137400","피엔티","42200","53700","11500","27.25","5591651","257535530300"
"128660","피제이메탈","3900","4415","515","13.21","7638129","33266146565"
"006140","피제이전자","6250","7970","1720","27.52","5046087","39667446530"
"376180","피코그램","38500","52200","13700","35.58","20145869","914872984050"
"304840","피플바이오","8890","10050","1160","13.05","2956464","32574259290"
"062970","피피아이","2855","2940","85","2.98","420191","1194161890"
"087600","픽셀플러스","7860","8140","280","3.56","135172","1088607120"
"161580","필옵틱스","6950","7920","970","13.96","491507","3568483870"
"347770","핌스","13750","14050","300","2.18","619018","8554369500"
"163730","핑거","11850","12500","650","5.49","828355","10201456600"
"332710","하나금융14호스팩","2295","2295","0","0.00","0","0"
"341160","하나금융15호스팩","2280","2065","-215","-9.43","2073213","4344857655"
"343510","하나금융16호스팩","2200","2160","-40","-1.82","125068","272700990"
"388220","하나금융19호스팩","2140","2125","-15","-0.70","175801","376076690"
"400560","하나금융20호스팩","2280","2220","-60","-2.63","583022","1303603220"
"406760","하나금융21호스팩","2120","2115","-5","-0.24","157488","334544010"
"418170","하나금융22호스팩","2120","2105","-15","-0.71","235085","499754370"
"086790","하나금융지주","37200","39800","2600","6.99","33151492","1212429089165"
"299030","하나기술","51500","54600","3100","6.02","510530","27815852850"
"067310","하나마이크론","13200","12700","-500","-3.79","14456308","190289391100"
"372290","하나머스트7호스팩","2160","2150","-10","-0.46","235137","506236330"
"166090","하나머티리얼즈","43600","37400","-6200","-14.22","3985517","161286427400"
"293480","하나제약","17750","17900","150","0.85","314144","5573954050"
"039130","하나투어","53000","50100","-2900","-5.47","2870841","142572945750"
"136480","하림","3040","2980","-60","-1.97","21788388","64823390245"
"003380","하림지주","8340","8780","440","5.28","4927960","40332014270"
"365590","하이딥","1650","1750","100","6.06","24352096","41519954125"
"149980","하이로닉","7700","7610","-90","-1.17","3041596","22575536790"
"013030","하이록코리아","17100","22250","5150","30.12","2810744","55725567100"
"352820","하이브","164500","178500","14000","8.51","6450558","1088873244500"
"126700","하이비젼시스템","15250","16600","1350","8.85","2466747","39397325150"
"106080","하이소닉","5650","5650","0","0.00","0","0"
"071090","하이스틸","4260","4340","80","1.88","4400726","18435509295"
"377400","하이제6호스팩","2135","2165","30","1.41","244784","524570320"
"400840","하이제7호스팩","2130","2120","-10","-0.47","241529","513195130"
"221840","하이즈항공","4000","4180","180","4.50","1114174","4575841865"
"106190","하이텍팜","10000","9950","-50","-0.50","139365","1375858050"
"019490","하이트론","2470","2470","0","0.00","0","0"
"000080","하이트진로","30650","31350","700","2.28","4790130","144887581950"
"000087","하이트진로2우B","19150","18900","-250","-1.31","39620","736002800"
"000140","하이트진로홀딩스","11250","11650","400","3.56","529025","6193479600"
"000145","하이트진로홀딩스우","14350","15100","750","5.23","3851","56493350"
"373200","하인크코리아","10150","7420","-2730","-26.90","23870424","192480826450"
"066130","하츠","6270","7750","1480","23.60","6636580","51498465780"
"152550","한국ANKOR유전","1570","1595","25","1.59","244521","384839390"
"004590","한국가구","5830","6610","780","13.38","11377852","70973310710"
"036460","한국가스공사","35150","37900","2750","7.82","6845090","244017641350"
"039340","한국경제TV","5900","6230","330","5.59","555465","3349183760"
"005430","한국공항","38400","39150","750","1.95","108310","4082274650"
"071050","한국금융지주","61600","61700","100","0.16","4436720","269477368300"
"071055","한국금융지주우","57900","56300","-1600","-2.76","137426","7709065700"
"034950","한국기업평가","73400","72600","-800","-1.09","24336","1744486200"
"010040","한국내화","3190","3350","160","5.02","625260","2016155290"
"025540","한국단자","51900","58300","6400","12.33","282454","15806806100"
"222980","한국맥널티","6220","6390","170","2.73","5206277","34280328620"
"331660","한국미라클피플사","15150","13000","-2150","-14.19","1525","20711400"
"256840","한국비엔씨","8370","11400","3030","36.20","149472299","1813985272800"
"004090","한국석유","11600","11650","50","0.43","2959834","33335371700"
"025550","한국선재","4305","5010","705","16.38","8929736","42113666290"
"002200","한국수출포장","22950","23800","850","3.70","107011","2401624700"
"002960","한국쉘석유","245500","248500","3000","1.22","18623","4554980000"
"017890","한국알콜","9730","11300","1570","16.14","3111613","32641013300"
"000240","한국앤컴퍼니","12000","13150","1150","9.58","2060973","25267341050"
"080720","한국유니온제약","7220","8230","1010","13.99","629201","4962085110"
"123890","한국자산신탁","3450","3500","50","1.45","2020772","6922849500"
"015760","한국전력","22200","21650","-550","-2.48","21646701","472838384600"
"063570","한국전자금융","5010","5210","200","3.99","1173850","5931513060"
"041460","한국전자인증","5650","6230","580","10.27","5710019","34876490420"
"006200","한국전자홀딩스","1385","1470","85","6.14","3554015","5035854320"
"101680","한국정밀기계","1440","1440","0","0.00","0","0"
"039740","한국정보공학","3795","4320","525","13.83","11953312","50751725395"
"053300","한국정보인증","5790","6040","250","4.32","3376683","20611026460"
"025770","한국정보통신","7540","10600","3060","40.58","16956404","174386920770"
"409570","한국제10호스팩","2165","2145","-20","-0.92","104295","224623635"
"009540","한국조선해양","83300","93000","9700","11.64","4020962","341192187400"
"023350","한국종합기술","7440","7860","420","5.65","12253816","90769702670"
"025890","한국주강","2740","2740","0","0.00","474030","1268825760"
"000970","한국주철관","8120","8340","220","2.71","2400567","20276590510"
"104700","한국철강","6710","7100","390","5.81","1153626","7875382340"
"017960","한국카본","13000","15200","2200","16.92","17943359","249974599200"
"023760","한국캐피탈","779","808","29","3.72","1990192","1581315064"
"054040","한국컴퓨터","3725","3960","235","6.31","1177296","4575013140"
"050540","한국코퍼레이션","822","822","0","0.00","0","0"
"161890","한국콜마","38600","37500","-1100","-2.85","2020877","77197243150"
"024720","한국콜마홀딩스","17300","17000","-300","-1.73","404201","7052012600"
"021650","한국큐빅","3010","3185","175","5.81","2132998","6895415630"
"161390","한국타이어앤테크놀로지","32750","39700","6950","21.22","7508559","262658819700"
"053590","한국테크놀로지","703","761","58","8.25","16724522","13076207815"
"034830","한국토지신탁","1670","1685","15","0.90","18817922","30204638870"
"007280","한국특강","2495","2440","-55","-2.20","1134469","2728054390"
"032300","한국파마","25750","31900","6150","23.88","18083467","660055672650"
"168490","한국패러랠","2135","2180","45","2.11","681721","1488054670"
"037230","한국팩키지","3105","3420","315","10.14","12388135","45328092460"
"010100","한국프랜지","2505","2670","165","6.59","1019161","2567116700"
"047810","한국항공우주","49450","55500","6050","12.23","38340941","2094184109400"
"123690","한국화장품","7210","7280","70","0.97","586992","4195161600"
"003350","한국화장품제조","22400","22100","-300","-1.34","135353","2939293650"
"030520","한글과컴퓨터","17150","16600","-550","-3.21","2652395","45753025800"
"052600","한네트","7080","7840","760","10.73","12937426","100460053500"
"011500","한농화성","12300","14400","2100","17.07","1619911","21392206550"
"002390","한독","17700","18450","750","4.24","306435","5565170150"
"256150","한독크린텍","11000","10800","-200","-1.82","444901","4781626150"
"014790","한라","4015","4700","685","17.06","12532425","56089300305"
"092460","한라IMS","5140","5740","600","11.67","1336019","7209959440"
"060980","한라홀딩스","36250","38300","2050","5.66","333303","12681584800"
"053690","한미글로벌","11550","12450","900","7.79","6352069","74100053200"
"042700","한미반도체","12850","12700","-150","-1.17","10541629","143865825500"
"008930","한미사이언스","41000","41550","550","1.34","1621541","66224575300"
"128940","한미약품","322500","320000","-2500","-0.78","677235","211325253000"
"047080","한빛소프트","3225","3430","205","6.36","1458713","4797871050"
"009240","한샘","60800","54300","-6500","-10.69","1512198","85157557600"
"020000","한섬","30750","29150","-1600","-5.20","1678192","50187187750"
"003680","한성기업","6290","6700","410","6.52","6458189","44167938740"
"105630","한세실업","16900","17150","250","1.48","6868441","115384235100"
"069640","한세엠케이","3370","3540","170","5.04","1038465","4021018450"
"016450","한세예스24홀딩스","5860","5810","-50","-0.85","374571","2194571470"
"010420","한솔PNS","1560","1675","115","7.37","1260814","2014315235"
"009180","한솔로지스틱스","3280","3485","205","6.25","5201343","17318529580"
"070590","한솔인티큐브","1910","1950","40","2.09","990390","1896843020"
"213500","한솔제지","13300","14800","1500","11.28","2730507","38766528250"
"014680","한솔케미칼","214000","213500","-500","-0.23","1021975","222986700000"
"004710","한솔테크닉스","5170","6190","1020","19.73","6084045","36890735545"
"004150","한솔홀딩스","3080","3415","335","10.88","1830918","5983613265"
"025750","한솔홈데코","1330","1445","115","8.65","11590100","16124950220"
"226440","한송네오텍","1530","1530","0","0.00","0","0"
"042520","한스바이오메드","10150","10750","600","5.91","243832","2581493850"
"004960","한신공영","12150","13050","900","7.41","2415878","29244683450"
"011700","한신기계","9080","9300","220","2.42","40442231","362546746450"
"078350","한양디지텍","12900","14150","1250","9.69","1737325","23425577950"
"045100","한양이엔지","14000","14800","800","5.71","1546952","22491220200"
"001750","한양증권","10450","11300","850","8.13","165515","1777507050"
"001755","한양증권우","15150","17000","1850","12.21","6630","104440400"
"018880","한온시스템","10000","11150","1150","11.50","11486032","119792140870"
"009420","한올바이오파마","17000","17100","100","0.59","3231076","54420029800"
"014130","한익스프레스","5210","5170","-40","-0.77","631732","3258637115"
"046110","한일네트웍스","12000","12450","450","3.75","461286","5619227650"
"024740","한일단조","2745","3355","610","22.22","54513271","180939335910"
"005860","한일사료","6910","5190","-1720","-24.89","42918643","267761056940"
"300720","한일시멘트","13900","15350","1450","10.43","5897845","92825467550"
"123840","한일진공","599","602","3","0.50","1484892","902353959"
"002220","한일철강","3920","4315","395","10.08","1278441","5148897745"
"006390","한일현대시멘트","22450","25250","2800","12.47","335268","8452810850"
"003300","한일홀딩스","10800","11300","500","4.63","59212","640774200"
"007770","한일화학","21700","20050","-1650","-7.60","2954989","61235020450"
"051600","한전KPS","38300","41750","3450","9.01","4466859","172639194150"
"052690","한전기술","68000","73000","5000","7.35","5443428","357455181700"
"130660","한전산업","10800","11000","200","1.85","4215065","44274877920"
"107640","한중엔시에스","11500","12950","1450","12.61","1899","22252350"
"002320","한진","28150","26550","-1600","-5.68","677006","18336914400"
"003480","한진중공업홀딩스","4125","4090","-35","-0.85","1378549","5539995995"
"180640","한진칼","59400","60900","1500","2.53","1238861","73597562100"
"18064K","한진칼우","33700","33300","-400","-1.19","30111","984927900"
"005110","한창","970","1155","185","19.07","211472753","236366383358"
"043090","한창바이오텍","1925","4570","2645","137.40","55133581","225302453295"
"079170","한창산업","7640","8500","860","11.26","12698344","117107119430"
"009460","한창제지","1635","1725","90","5.50","5513460","9460731275"
"086960","한컴MDS","12200","17250","5050","41.39","11803520","193719463650"
"372910","한컴라이프케어","5190","5490","300","5.78","3714899","20935152880"
"054920","한컴위드","4990","5290","300","6.01","8181588","45517004415"
"002680","한탑","2470","1885","-585","-23.68","28014084","58838325930"
"000880","한화","24750","30850","6100","24.65","8295755","228301434350"
"00088K","한화3우B","14100","15650","1550","10.99","1100472","16372240100"
"088350","한화생명","2170","2320","150","6.91","32222849","70945349625"
"000370","한화손해보험","4120","4930","810","19.66","15253572","73380153485"
"009830","한화솔루션","34600","46600","12000","34.68","55983289","2299713677350"
"009835","한화솔루션우","35550","49650","14100","39.66","2885592","139489908500"
"272210","한화시스템","12800","15400","2600","20.31","18353943","259426349150"
"012450","한화에어로스페이스","44600","70000","25400","56.95","39616149","2437653058250"
"000885","한화우","33300","37500","4200","12.61","33799","1217894300"
"003530","한화투자증권","3275","3365","90","2.75","21923702","71982808465"
"003535","한화투자증권우","7690","7450","-240","-3.12","227321","1675456520"
"386580","한화플러스제2호스팩","2205","2180","-25","-1.13","403501","885535840"
"195870","해성디에스","56900","56200","-700","-1.23","6313010","370641369100"
"034810","해성산업","10500","11850","1350","12.86","826658","8939150490"
"03481K","해성산업1우","14600","15900","1300","8.90","218392","3343906800"
"076610","해성옵틱스","827","756","-71","-8.59","10701309","8422684803"
"059270","해성티피씨","6280","7840","1560","24.84","11965375","95054472530"
"101530","해태제과식품","7060","7240","180","2.55","3475297","28466998530"
"220180","핸디소프트","4255","4155","-100","-2.35","13393882","67911584990"
"143210","핸즈코퍼레이션","4010","4145","135","3.37","351477","1455259220"
"900270","헝셩그룹","368","343","-25","-6.79","10020855","3522955993"
"214180","헥토이노베이션","14650","15250","600","4.10","484294","7335272750"
"234340","헥토파이낸셜","18950","22450","3500","18.47","985217","21115136200"
"084990","헬릭스미스","19650","18400","-1250","-6.36","3144953","58056875850"
"000720","현대건설","39550","46650","7100","17.95","12664732","531919775750"
"267270","현대건설기계","42600","40150","-2450","-5.75","4155053","162006349100"
"000725","현대건설우","70700","73300","2600","3.68","78167","5419004900"
"170030","현대공업","6940","7900","960","13.83","24490449","189856777830"
"005440","현대그린푸드","7720","7900","180","2.33","2667913","20467542560"
"086280","현대글로비스","180000","181500","1500","0.83","2222176","402727726500"
"042670","현대두산인프라코어","5320","5810","490","9.21","23862255","131364877440"
"064350","현대로템","19300","25200","5900","30.57","153319331","3768313348100"
"079430","현대리바트","11100","11600","500","4.50","630933","7138203200"
"012330","현대모비스","204500","223500","19000","9.29","4883997","1077354349408"
"319400","현대무벡스","3050","3180","130","4.26","22991313","73262494795"
"010620","현대미포조선","80500","107000","26500","32.92","6708828","627136886906"
"048410","현대바이오","24700","28850","4150","16.80","15219808","428058936050"
"052260","현대바이오랜드","11800","14800","3000","25.42","8062962","127920747900"
"069960","현대백화점","67100","67400","300","0.45","1334355","87616984600"
"004560","현대비앤지스틸","12650","14000","1350","10.67","1537542","20544969550"
"004565","현대비앤지스틸우","63300","60900","-2400","-3.79","5844","356518200"
"004310","현대약품","5840","5530","-310","-5.31","58800426","362177817310"
"322000","현대에너지솔루션","32200","55900","23700","73.60","17200034","821381506850"
"041440","현대에버다임","9650","8190","-1460","-15.13","29367942","259939802150"
"039010","현대에이치티","8140","8670","530","6.51","143458","1222484810"
"017800","현대엘리베이","26350","30000","3650","13.85","2572993","70834081550"
"307950","현대오토에버","113500","126500","13000","11.45","1259858","156940868500"
"011210","현대위아","55600","69900","14300","25.72","5913207","375909987600"
"090850","현대이지웰","7580","7780","200","2.64","4393115","35166185500"
"267260","현대일렉트릭","23900","30400","6500","27.20","11450813","295266640150"
"004020","현대제철","32750","34400","1650","5.04","9106327","299725743700"
"329180","현대중공업","125500","139500","14000","11.16","5051493","641996057500"
"005380","현대차","178000","193500","15500","8.71","19877388","3793499182404"
"005387","현대차2우B","86400","92500","6100","7.06","1585920","146381577198"
"005389","현대차3우B","83600","88800","5200","6.22","128429","11380866900"
"005385","현대차우","87000","92100","5100","5.86","915757","84393752700"
"001500","현대차증권","9670","10500","830","8.58","743759","7603640340"
"011760","현대코퍼레이션","15500","17350","1850","11.94","1211329","19877882450"
"227840","현대코퍼레이션홀딩스","10500","11600","1100","10.48","463693","5050514600"
"126560","현대퓨처넷","2505","2835","330","13.17","28323067","84956051260"
"001450","현대해상","30650","33500","2850","9.30","7505854","245888371200"
"057050","현대홈쇼핑","50700","51300","600","1.18","209025","10678014750"
"092300","현우산업","4340","4740","400","9.22","16705161","77612546200"
"138360","협진","4480","4480","0","0.00","0","0"
"011080","형지I&C","872","700","-172","-19.72","3318711","2747984152"
"093240","형지엘리트","1595","1720","125","7.84","8022219","13782392600"
"003010","혜인","8530","7830","-700","-8.21","14992677","116919733300"
"111110","호전실업","8290","9030","740","8.93","751000","6554715570"
"008770","호텔신라","69700","73000","3300","4.73","4112934","289436850500"
"008775","호텔신라우","56800","59800","3000","5.28","35470","2078778200"
"060560","홈센타홀딩스","1270","1480","210","16.54","93720166","130998257880"
"064240","홈캐스트","3575","4720","1145","32.03","5013850","20025508860"
"039610","화성밸브","5340","6750","1410","26.40","17612732","119667683970"
"002460","화성산업","18850","17550","-1300","-6.90","1201098","21062963850"
"378850","화승알앤에이","3470","3480","10","0.29","834669","2849392185"
"241590","화승엔터프라이즈","11750","12150","400","3.40","3753263","44591352750"
"006060","화승인더","4665","5020","355","7.61","2657414","13026041260"
"013520","화승코퍼레이션","1525","1480","-45","-2.95","2843803","4064912325"
"010690","화신","8780","9960","1180","13.44","20111877","198702978120"
"126640","화신정공","1610","1755","145","9.01","8004949","13624716000"
"133820","화인베스틸","2605","2995","390","14.97","3403065","8881209410"
"061250","화일약품","2620","2695","75","2.86","47110231","138087178655"
"010660","화천기계","2570","3205","635","24.71","23922254","77902276070"
"000850","화천기공","31950","34200","2250","7.04","122652","4240102950"
"016580","환인제약","16750","17150","400","2.39","403158","6817205600"
"032560","황금에스티","7320","7780","460","6.28","2470948","18454921690"
"004800","효성","76500","75300","-1200","-1.57","896884","66786065400"
"094280","효성ITX","14300","15000","700","4.90","161194","2382617800"
"097870","효성오앤비","9760","9760","0","0.00","4286597","40935064790"
"298040","효성중공업","57100","66200","9100","15.94","1052001","61682034900"
"298050","효성첨단소재","363500","417000","53500","14.72","890198","325143335748"
"298020","효성티앤씨","330000","340500","10500","3.18","765690","244672688000"
"298000","효성화학","176500","189000","12500","7.08","215055","38666310500"
"093370","후성","17700","15900","-1800","-10.17","58716943","994962749450"
"081660","휠라홀딩스","28500","30100","1600","5.61","4514587","133689143000"
"290270","휴네시온","4185","4435","250","5.97","250749","1092181815"
"005870","휴니드","7100","8110","1010","14.23","3840983","29363462090"
"353190","휴럼","1170","1325","155","13.25","10384610","13492484060"
"090710","휴림로봇","3000","3170","170","5.67","405420950","1247540507500"
"205470","휴마시스","18300","18900","600","3.28","124278550","2622222270650"
"115160","휴맥스","3330","3765","435","13.06","13320971","50341776600"
"028080","휴맥스홀딩스","3380","3510","130","3.85","2140202","7877380810"
"032860","휴먼엔","3640","3640","0","0.00","0","0"
"200670","휴메딕스","21600","24450","2850","13.19","1039636","24742964500"
"212310","휴벡셀","6000","5950","-50","-0.83","37076","211954820"
"079980","휴비스","6270","6390","120","1.91","487311","3104482180"
"065510","휴비츠","10950","10600","-350","-3.20","6580112","73136532550"
"215090","휴센텍","1505","1505","0","0.00","0","0"
"005010","휴스틸","4390","4320","-70","-1.59","6619476","27116437960"
"263920","휴엠앤씨","4555","4555","0","0.00","0","0"
"243070","휴온스","35950","38000","2050","5.70","356688","13203581100"
"084110","휴온스글로벌","21800","22900","1100","5.05","1000871","23473087350"
"145020","휴젤","109800","129600","19800","18.03","2414045","303500722600"
"024060","흥구석유","6170","6250","80","1.30","1700479","10448362650"
"010240","흥국","6900","7190","290","4.20","990644","6758992130"
"189980","흥국에프엔비","2910","3190","280","9.62","12024527","38721421640"
"000540","흥국화재","3190","3370","180","5.64","2944484","9468981665"
"000547","흥국화재2우B","22700","22150","-550","-2.42","13346","288922800"
"000545","흥국화재우","7070","7170","100","1.41","17935","126062930"
"003280","흥아해운","2095","1835","-260","-12.41","12585270","23232076500"
"037440","희림","8100","10250","2150","26.54","74589836","674369637410"
"238490","힘스","6240","7670","1430","22.92","3846745","29775643600"