종목코드,종목명,시작일 기준가,종료일 종가,대비,등락률,거래량,거래대금
"060310","3S","2885","2905","20","0.69","13177348","39298879635"
"095570","AJ네트웍스","6520","7840","1320","20.25","2253647","17059523490"
"006840","AK홀딩스","16250","16350","100","0.62","263837","4263082800"
"054620","APS홀딩스","8190","10600","2410","29.43","1935756","18931270460"
"265520","AP시스템","16900","18600","1700","10.06","1532571","26809347800"
"211270","AP위성","11500","11700","200","1.74","6623676","79398574650"
"027410","BGF","4170","4315","145","3.48","2868571","12021720760"
"282330","BGF리테일","189500","172500","-17000","-8.97","807274","146268596000"
"032790","BNGT","4075","4075","0","0.00","0","0"
"138930","BNK금융지주","6630","6810","180","2.71","21546832","142643784806"
"001460","BYC","404500","416000","11500","2.84","2064","853853000"
"001465","BYC우","157000","156000","-1000","-0.64","1365","212689500"
"013720","CBI","1365","1955","590","43.22","50328353","102692876745"
"001040","CJ","77700","80300","2600","3.35","601028","47226474600"
"079160","CJ CGV","21950","21400","-550","-2.51","4699248","98900153600"
"035760","CJ ENM","95800","100800","5000","5.22","1873559","187151042100"
"311690","CJ 바이오사이언스","31450","34650","3200","10.17","434452","14607933400"
"00104K","CJ4우(전환)","70400","71500","1100","1.56","157761","11071737000"
"000120","CJ대한통운","122000","125500","3500","2.87","1114260","130074440000"
"011150","CJ씨푸드","3190","3405","215","6.74","7054419","24041203105"
"011155","CJ씨푸드1우","29750","28550","-1200","-4.03","5054","142095550"
"001045","CJ우","48050","49600","1550","3.23","40952","1971431600"
"097950","CJ제일제당","389000","419500","30500","7.84","969720","392248832000"
"097955","CJ제일제당 우","165500","177000","11500","6.95","30737","5266838000"
"051500","CJ프레시웨이","39150","40400","1250","3.19","1788838","68454157350"
"058820","CMG제약","2620","2855","235","8.97","12378152","33905236465"
"023460","CNH","1795","1935","140","7.80","339775","635750640"
"056730","CNT85","3100","3100","0","0.00","0","0"
"065770","CS","2095","2210","115","5.49","4619727","10324200025"
"083660","CSA 코스믹","1525","1450","-75","-4.92","957164","1400996870"
"000590","CS홀딩스","59400","66500","7100","11.95","231075","15057787100"
"012030","DB","797","832","35","4.39","5318373","4319901381"
"404950","DB금융스팩10호","2100","2095","-5","-0.24","229012","483322700"
"367340","DB금융스팩8호","2135","2130","-5","-0.23","249157","528821720"
"367360","DB금융스팩9호","2155","2125","-30","-1.39","197265","417593585"
"016610","DB금융투자","5020","5240","220","4.38","672040","3373775760"
"005830","DB손해보험","58200","62800","4600","7.90","3206870","197272586855"
"000990","DB하이텍","49000","42900","-6100","-12.45","20486546","888841136450"
"000995","DB하이텍1우","93700","71100","-22600","-24.12","8669","703823900"
"139130","DGB금융지주","7790","7580","-210","-2.70","7807153","59344978800"
"001530","DI동일","16100","19900","3800","23.60","2038467","36041305250"
"000210","DL","67300","68000","700","1.04","2706537","179796666500"
"001880","DL건설","20750","21950","1200","5.78","447809","9542362800"
"000215","DL우","39100","39750","650","1.66","41599","1641498200"
"375500","DL이앤씨","40250","43900","3650","9.07","4781142","193632459200"
"37550L","DL이앤씨2우(전환)","34250","34950","700","2.04","47013","1600570450"
"37550K","DL이앤씨우","28550","29850","1300","4.55","68392","1968563650"
"068790","DMS","5050","5590","540","10.69","1201152","6451404075"
"007340","DN오토모티브","53000","56000","3000","5.66","411049","21925136350"
"004840","DRB동일","4520","4615","95","2.10","270377","1230768040"
"241520","DSC인베스트먼트","4180","4630","450","10.77","6330783","28996648995"
"155660","DSR","5400","6150","750","13.89","1674362","9564970360"
"069730","DSR제강","4795","5360","565","11.78","1244522","6225827225"
"017940","E1","44950","45200","250","0.56","188668","8311651000"
"245620","EDGC","3280","2840","-440","-13.41","44146228","150247432295"
"037370","EG","9200","10500","1300","14.13","804894","7952549810"
"278990","EMB","5490","5990","500","9.11","17863","90538320"
"365550","ESR켄달스퀘어리츠","5460","5530","70","1.28","5017467","26374216534"
"050120","ES큐브","3900","3840","-60","-1.54","786666","3069207095"
"084180","EV수성","1525","1370","-155","-10.16","22197711","32979156725"
"383220","F&F","138000","155500","17500","12.68","2722032","407117477500"
"007700","F&F홀딩스","18800","19800","1000","5.32","795527","15541747150"
"214270","FSN","4420","5040","620","14.03","21211684","111255013590"
"130500","GH신소재","4910","4955","45","0.92","30713116","171286250890"
"114090","GKL","13950","15000","1050","7.53","5024277","71205194600"
"900290","GRT","1240","1300","60","4.84","2698047","3443414950"
"078930","GS","39650","42800","3150","7.94","3838080","154588960150"
"083450","GST","21750","21850","100","0.46","1597676","35027710000"
"006360","GS건설","29550","32050","2500","8.46","15669055","462325365700"
"001250","GS글로벌","3240","3905","665","20.52","229878540","842396365230"
"007070","GS리테일","25500","25750","250","0.98","4901528","120538188650"
"078935","GS우","34550","35150","600","1.74","59429","2033267850"
"297890","HB솔루션","13100","13600","500","3.82","1158738","15434126000"
"078150","HB테크놀러지","1865","2030","165","8.85","13783206","27850988975"
"012630","HDC","6540","6940","400","6.12","1232158","8254267320"
"039570","HDC랩스","8460","8810","350","4.14","890109","8271685980"
"089470","HDC현대EP","3865","4250","385","9.96","435611","1763237170"
"294870","HDC현대산업개발","11450","13100","1650","14.41","6960372","82925118850"
"267250","HD현대","52900","58300","5400","10.21","3178809","171833911650"
"097230","HJ중공업","6800","6870","70","1.03","278277","1894551660"
"195940","HK이노엔","40150","43800","3650","9.09","12456079","531195972750"
"028300","HLB","40300","47750","7450","18.49","26068170","1143389592300"
"003580","HLB글로벌","10100","9660","-440","-4.36","13465171","131722714890"
"343090","HLB사이언스","4100","4180","80","1.95","320386","1244809835"
"067630","HLB생명과학","13000","14200","1200","9.23","26074449","348193701750"
"047920","HLB제약","15650","16550","900","5.75","7831902","119598053650"
"115450","HLB테라퓨틱스","13400","12100","-1300","-9.70","5133582","64154700300"
"011200","HMM","25100","25350","250","1.00","39415954","954909209100"
"036640","HRS","6190","6720","530","8.56","2678806","16952785290"
"082740","HSD엔진","7298","8680","1382","18.94","9068574","80522185950"
"335870","IBKS제12호스팩","2460","2890","430","17.48","6091608","15362302930"
"351340","IBKS제13호스팩","2030","2020","-10","-0.49","1339590","2762906440"
"388790","IBKS제16호스팩","2225","2225","0","0.00","0","0"
"405350","IBKS제17호스팩","2280","2270","-10","-0.44","458950","1052079215"
"003560","IHQ","719","727","8","1.11","11359484","8565320391"
"095340","ISC","32550","31350","-1200","-3.69","4490646","148211623350"
"099520","ITX-AI","1285","1285","0","0.00","0","0"
"175330","JB금융지주","7130","7370","240","3.37","5817655","42438004790"
"950170","JTC","2845","2690","-155","-5.45","658792","1773216845"
"234080","JW생명과학","13350","13700","350","2.62","271277","3691256500"
"067290","JW신약","3845","4140","295","7.67","8714657","35793768510"
"001060","JW중외제약","24050","23050","-1000","-4.16","1743326","42510632700"
"001067","JW중외제약2우B","70300","70500","200","0.28","2852","202825700"
"001065","JW중외제약우","36600","36550","-50","-0.14","5644","203467550"
"096760","JW홀딩스","3360","3460","100","2.98","705792","2439774275"
"035900","JYP Ent.","53400","57600","4200","7.87","8269688","463362368900"
"318000","KBG","5930","6610","680","11.47","1030806","6447596360"
"024840","KBI메탈","1715","1835","120","7.00","2625368","4726133390"
"105560","KB금융","47000","51400","4400","9.36","25542505","1213925608851"
"024120","KB오토시스","5620","5480","-140","-2.49","1317303","7134167040"
"002380","KCC","287500","307500","20000","6.96","772545","225452583500"
"021320","KCC건설","6870","7270","400","5.82","422106","2899871020"
"344820","KCC글라스","44800","49400","4600","10.27","494454","22797768700"
"036670","KCI","8190","8870","680","8.30","209918","1806388780"
"009070","KCTC","4460","5180","720","16.14","8291232","43621886280"
"009440","KC그린홀딩스","5020","4945","-75","-1.49","2666986","13055928005"
"112190","KC산업","3420","3695","275","8.04","15758","53561315"
"119650","KC코트렐","4230","4625","395","9.34","1189644","5274229630"
"044180","KD","1035","1075","40","3.86","1591798","1627265425"
"092220","KEC","2545","2725","180","7.07","44109664","119269331870"
"151860","KG ETS","15850","15700","-150","-0.95","27281435","418918135050"
"046440","KG모빌리언스","7130","7320","190","2.66","3763333","26297602290"
"016380","KG스틸","13150","12700","-450","-3.42","14611183","181895890200"
"035600","KG이니시스","13700","14150","450","3.28","2477779","33958374450"
"001390","KG케미칼","26100","29150","3050","11.69","7648857","216720027900"
"226360","KH 건설","919","865","-54","-5.88","171524905","151927460582"
"111870","KH 전자","753","815","62","8.23","34528513","26647631010"
"033180","KH 필룩스","1525","1510","-15","-0.98","17043176","25238952820"
"060720","KH바텍","18200","19550","1350","7.42","4496375","90574854800"
"001940","KISCO홀딩스","14050","14250","200","1.42","409114","5713981600"
"058400","KNN","1010","1070","60","5.94","7206308","7516619634"
"114450","KPX생명과학","5280","5610","330","6.25","26522734","170860483210"
"025000","KPX케미칼","47950","51400","3450","7.19","49756","2462274300"
"092230","KPX홀딩스","59600","60500","900","1.51","15296","913980600"
"000040","KR모터스","633","717","84","13.27","57436045","44577380064"
"044450","KSS해운","9650","10900","1250","12.95","687484","6888867430"
"030200","KT","36650","38450","1800","4.91","16046552","602337642125"
"033780","KT&G","80700","81100","400","0.50","5087707","414067521600"
"058850","KTcs","2015","2400","385","19.11","19627640","45165100355"
"058860","KTis","2595","2815","220","8.48","7388495","19826159950"
"060370","KT서브마린","6450","6970","520","8.06","13909633","94722469220"
"122450","KX","7690","7860","170","2.21","984070","7498787390"
"052900","KX하이텍","1380","1505","125","9.06","10257768","15316981465"
"093050","LF","16150","17000","850","5.26","947865","15710259900"
"003550","LG","78400","81600","3200","4.08","3563936","280710625400"
"034220","LG디스플레이","15250","16450","1200","7.87","28444658","434760399000"
"051900","LG생활건강","714000","742000","28000","3.92","1245008","923910389271"
"051905","LG생활건강우","330500","363500","33000","9.98","109360","38336526500"
"373220","LG에너지솔루션","388000","469000","81000","20.88","12430246","5092534962500"
"003555","LG우","61400","62800","1400","2.28","40658","2505399100"
"032640","LG유플러스","12300","12600","300","2.44","15655125","193129733808"
"011070","LG이노텍","338000","342500","4500","1.33","4875945","1680593913500"
"066570","LG전자","92000","96300","4300","4.67","13267192","1236985241800"
"066575","LG전자우","44800","47150","2350","5.25","397012","18146114550"
"037560","LG헬로비전","5610","5480","-130","-2.32","12398026","70099721520"
"051910","LG화학","540000","670000","130000","24.07","6110382","3548712396491"
"051915","LG화학우","254500","326500","72000","28.29","328283","92203634558"
"079550","LIG넥스원","69400","90000","20600","29.68","5624521","466001751400"
"006260","LS","55400","62100","6700","12.09","3061745","170190928000"
"010120","LS ELECTRIC","53200","58800","5600","10.53","3550674","194708928100"
"000680","LS네트웍스","2650","3135","485","18.30","1866005","5572756740"
"229640","LS전선아시아","6920","7360","440","6.36","5772253","42465261980"
"108320","LX세미콘","95500","92900","-2600","-2.72","4566739","428216657200"
"001120","LX인터내셔널","29600","33600","4000","13.51","5915903","184322365500"
"108670","LX하우시스","42100","45250","3150","7.48","530738","22763461050"
"108675","LX하우시스우","20400","21900","1500","7.35","64932","1308135200"
"383800","LX홀딩스","8950","8690","-260","-2.91","2967111","25718521360"
"38380K","LX홀딩스1우","12150","12250","100","0.82","67920","813995350"
"023150","MH에탄올","8550","9090","540","6.32","3313123","31559357070"
"035420","NAVER","249000","269500","20500","8.23","14915167","3763316313094"
"160550","NEW","7150","8490","1340","18.74","7340024","57661833460"
"053290","NE능률","5410","5640","230","4.25","20898599","135678206520"
"181710","NHN","27650","29400","1750","6.33","2254221","63804916350"
"104200","NHN벅스","9070","9270","200","2.21","6655892","63728616150"
"060250","NHN한국사이버결제","12850","13650","800","6.23","14080409","195360773550"
"400760","NH올원리츠","4540","4630","90","1.98","1099528","4900739510"
"005940","NH투자증권","9230","10050","820","8.88","12917819","122530771270"
"005945","NH투자증권우","9210","9910","700","7.60","732685","6958907750"
"338100","NH프라임리츠","4660","4670","10","0.21","621469","2856507125"
"034310","NICE","14600","13450","-1150","-7.88","1154382","16115604600"
"030190","NICE평가정보","14250","16500","2250","15.79","2055255","31108728833"
"008260","NI스틸","4850","5030","180","3.71","2525432","12512171520"
"004250","NPC","8770","9720","950","10.83","38240870","364705038950"
"004255","NPC우","4725","5060","335","7.09","6617736","34761567180"
"010060","OCI","127000","126500","-500","-0.39","14204674","1667757703000"
"178920","PI첨단소재","33850","38700","4850","14.33","2485640","88640720150"
"024940","PN풍년","4910","5710","800","16.29","4704204","24244894455"
"005490","POSCO홀딩스","231000","255000","24000","10.39","5988027","1403368850630"
"218410","RFHIC","21900","23650","1750","7.99","2139506","48242191250"
"327260","RF머트리얼즈","11150","10800","-350","-3.14","349062","3844971700"
"091340","S&K폴리텍","4235","4500","265","6.26","192489","836259660"
"010950","S-Oil","93000","86400","-6600","-7.10","9542174","854915055172"
"010955","S-Oil우","58000","56700","-1300","-2.24","301253","17277533200"
"019550","SBI인베스트먼트","1550","1465","-85","-5.48","20753773","30149140100"
"950110","SBI핀테크솔루션즈","4305","4805","500","11.61","125841","579112665"
"034120","SBS","42600","43650","1050","2.46","937893","39039433200"
"046140","SBS콘텐츠허브","6030","7050","1020","16.92","2105475","14839027800"
"151910","SBW생명과학","3800","3240","-560","-14.74","5389726","19284581630"
"036120","SCI평가정보","3340","2970","-370","-11.08","18460230","62573170645"
"099220","SDN","2510","3030","520","20.72","276112349","809942656620"
"036540","SFA반도체","5140","5340","200","3.89","34576926","185184198915"
"255220","SG","1595","1780","185","11.60","25946995","47931716140"
"040610","SG&G","1995","2140","145","7.27","9355647","19991750770"
"049470","SGA","943","940","-3","-0.32","4114263","3861798510"
"184230","SGA솔루션즈","865","985","120","13.87","36941953","37725747932"
"005090","SGC에너지","33600","38350","4750","14.14","1513452","54122694350"
"016250","SGC이테크건설","43500","50100","6600","15.17","114063","5301825250"
"001380","SG글로벌","1360","1495","135","9.93","2802501","4143899990"
"004060","SG세계물산","560","618","58","10.36","16701790","9835372699"
"001770","SHD","30050","32150","2100","6.99","200684","6095074100"
"002360","SH에너지화학","1000","1115","115","11.50","104069717","111318685617"
"009160","SIMPAC","6250","6550","300","4.80","2782537","17458508050"
"123700","SJM","3500","3660","160","4.57","187803","677003180"
"025530","SJM홀딩스","3005","3130","125","4.16","1323047","4005008595"
"034730","SK","208500","229000","20500","9.83","2523749","543959860988"
"337450","SK5호스팩","5040","3405","-1635","-32.44","64369408","322735459310"
"340350","SK6호스팩","2265","2115","-150","-6.62","7888943","17130508965"
"011790","SKC","132000","133000","1000","0.76","4332732","570751116000"
"018670","SK가스","112000","116000","4000","3.57","261144","29161823000"
"001740","SK네트웍스","4250","4370","120","2.82","8246132","35951397545"
"001745","SK네트웍스우","57600","61800","4200","7.29","5168","304124400"
"006120","SK디스커버리","34800","36350","1550","4.45","337091","11981224150"
"006125","SK디스커버리우","30250","30800","550","1.82","35948","1095984850"
"210980","SK디앤디","24800","28250","3450","13.91","461186","11752888250"
"068400","SK렌터카","8260","8860","600","7.26","3410685","31773184040"
"395400","SK리츠","5710","5450","-260","-4.55","6704700","35978182180"
"302440","SK바이오사이언스","140000","124000","-16000","-11.43","20585908","2812797768000"
"326030","SK바이오팜","78800","80700","1900","2.41","2091569","164548019800"
"402340","SK스퀘어","39800","43550","3750","9.42","6695848","278190179070"
"260870","SK시그넷","48350","51100","2750","5.69","156475","8097704800"
"361610","SK아이이테크놀로지","82000","93800","11800","14.39","11038256","929314601800"
"03473K","SK우","184500","196000","11500","6.23","13629","2532210000"
"096770","SK이노베이션","171500","194500","23000","13.41","8268296","1492014648000"
"096775","SK이노베이션우","110500","120000","9500","8.60","44815","5114379500"
"001510","SK증권","726","773","47","6.47","21301875","15883494449"
"001515","SK증권우","2980","3095","115","3.86","113318","341043145"
"285130","SK케미칼","102000","106000","4000","3.92","1318380","138068254500"
"28513K","SK케미칼우","51700","53100","1400","2.71","141066","7452436400"
"017670","SK텔레콤","54000","52700","-1300","-2.41","11016176","590479779001"
"000660","SK하이닉스","94800","94300","-500","-0.53","66336176","6485338463162"
"048550","SM C&C","3350","4080","730","21.79","50761608","197698223255"
"063440","SM Life Design","2130","2400","270","12.68","20464711","48250035300"
"064960","SNT모티브","41000","42000","1000","2.44","806291","34618031500"
"100840","SNT에너지","16550","17800","1250","7.55","608518","9892547700"
"003570","SNT중공업","6800","9130","2330","34.26","11010421","92280399960"
"036530","SNT홀딩스","15450","15600","150","0.97","495031","7927023800"
"005610","SPC삼립","80900","86300","5400","6.67","308094","25176636700"
"011810","STX","3275","3520","245","7.48","764500","2524054965"
"077970","STX엔진","13200","15750","2550","19.32","2817761","40848724400"
"071970","STX중공업","4260","4685","425","9.98","1447784","6264255260"
"002820","SUN&L","4590","4555","-35","-0.76","281807","1256599280"
"289080","SV인베스트먼트","2655","2915","260","9.79","21152222","62257555750"
"084870","TBH글로벌","1980","2050","70","3.54","1930005","3926310050"
"002710","TCC스틸","12600","14250","1650","13.10","16825020","228543434400"
"089230","THE E&M","456","543","87","19.08","32060279","17261981277"
"161570","THE MIDONG","1235","1255","20","1.62","759878","936610630"
"192410","THQ","4765","4550","-215","-4.51","8046514","38637533275"
"032540","TJ미디어","5830","6640","810","13.89","3430318","22069131950"
"022220","TKG애강","1880","1880","0","0.00","26628930","51800224120"
"069260","TKG휴켐스","19900","20150","250","1.26","3186781","62402331000"
"048770","TPC","4795","4875","80","1.67","15424846","75927653930"
"246690","TS인베스트먼트","2580","2350","-230","-8.91","34376738","83261459885"
"317240","TS트릴리온","853","872","19","2.23","7625097","6457015898"
"002900","TYM","2510","2445","-65","-2.59","166520498","428663911455"
"038340","UCI","1335","1335","0","0.00","0","0"
"073570","WI","1020","917","-103","-10.10","13741480","13586432297"
"024070","WISCOM","3300","3200","-100","-3.03","373518","1192171240"
"057030","YBM넷","4060","4695","635","15.64","16881525","87176895610"
"037270","YG PLUS","5470","6840","1370","25.05","17980287","112251272400"
"040300","YTN","3650","3620","-30","-0.82","276455","993626070"
"051390","YW","3680","3850","170","4.62","217790","814335275"
"052220","iMBC","3180","3460","280","8.81","1174543","3810626190"
"079940","가비아","11100","12250","1150","10.36","438145","5094589550"
"078890","가온미디어","8470","8380","-90","-1.06","3985381","33833987650"
"000500","가온전선","23150","21000","-2150","-9.29","386174","8464961750"
"399720","가온칩스","24650","27150","2500","10.14","13103078","337307711500"
"036620","감성코퍼레이션","1625","1770","145","8.92","9774618","16981938145"
"000860","강남제비스코","21050","23450","2400","11.40","152871","3426445550"
"217730","강스템바이오텍","2845","3940","1095","38.49","5093902","18005482845"
"035250","강원랜드","25450","25650","200","0.79","10568317","261862302400"
"114190","강원에너지","6370","5130","-1240","-19.47","6890454","38226870300"
"094480","갤럭시아머니트리","6080","7540","1460","24.01","39272699","301865851100"
"011420","갤럭시아에스엠","1865","2040","175","9.38","7105560","13858366445"
"039240","경남스틸","3275","3635","360","10.99","2914833","9825494395"
"053950","경남제약","2655","2545","-110","-4.14","19816681","57488826720"
"002100","경농","10850","11650","800","7.37","946915","10554735200"
"009450","경동나비엔","38450","39000","550","1.43","768048","30216653300"
"267290","경동도시가스","20550","23700","3150","15.33","1339918","30466304950"
"012320","경동인베스트","34000","34450","450","1.32","63599","2227329150"
"011040","경동제약","8930","8840","-90","-1.01","1658454","15047355950"
"000050","경방","12300","13100","800","6.50","107963","1389818450"
"214390","경보제약","7140","7180","40","0.56","278343","2000948760"
"012610","경인양행","5460","6030","570","10.44","2971709","17178401180"
"009140","경인전자","25500","27850","2350","9.22","74441","1962512300"
"024910","경창산업","2430","2610","180","7.41","1051702","2656074945"
"013580","계룡건설","25000","26000","1000","4.00","952098","23046456400"
"012200","계양전기","3060","3305","245","8.01","4629904","15193845465"
"012205","계양전기우","6670","5870","-800","-11.99","429388","2710152430"
"002140","고려산업","7070","4885","-2185","-30.91","29964916","180856224710"
"198440","고려시멘트","3450","3720","270","7.83","30129642","112849736140"
"049720","고려신용정보","11600","10550","-1050","-9.05","18622750","222235597500"
"010130","고려아연","463000","582000","119000","25.70","1109696","554830090000"
"002240","고려제강","20400","21550","1150","5.64","627389","12873745350"
"014570","고려제약","7700","8150","450","5.84","634117","5091814380"
"348150","고바이오랩","12750","14000","1250","9.80","744156","10184513800"
"098460","고영","13450","14700","1250","9.29","4811443","66746981905"
"035290","골드앤에스","2410","2425","15","0.62","9284807","24472892970"
"038530","골드퍼시픽","674","666","-8","-1.19","49896192","38839877870"
"900280","골든센츄리","371","382","11","2.96","35612114","14221579159"
"215000","골프존","139900","138600","-1300","-0.93","971056","135760231900"
"121440","골프존뉴딘홀딩스","7050","6920","-130","-1.84","885246","6040313470"
"183410","골프존데카","4390","4480","90","2.05","14412","61098520"
"366030","공구우먼","31600","11300","-20300","-64.24","34580951","514060147400"
"076340","관악산업","6700","6990","290","4.33","31564","165029030"
"009290","광동제약","6390","6700","310","4.85","8295529","57403321610"
"014200","광림","1490","1440","-50","-3.36","28621481","41113158235"
"017040","광명전기","3170","2935","-235","-7.41","19565655","58789440965"
"029480","광무","2855","3680","825","28.90","3798068","13969212165"
"017900","광전자","2260","2450","190","8.41","1609147","3771936715"
"037710","광주신세계","33300","33550","250","0.75","107960","3557119050"
"026910","광진실업","4895","5810","915","18.69","1254626","7077640035"
"355150","교보10호스팩","2240","2240","0","0.00","245621","549751790"
"397880","교보11호스팩","2145","2130","-15","-0.70","324126","696562715"
"421800","교보12호스팩","2105","2115","10","0.48","454236","961925490"
"331520","교보9호스팩","2470","2260","-210","-8.50","23918531","60270789405"
"030610","교보증권","6350","6440","90","1.42","727891","4553298020"
"339770","교촌에프앤비","11800","12150","350","2.97","750777","8918264700"
"053270","구영테크","3275","3370","95","2.90","17952926","61402623755"
"007690","국도화학","48850","51600","2750","5.63","549044","27085468950"
"005320","국동","1785","1800","15","0.84","27885793","55442783565"
"001140","국보","1190","1075","-115","-9.66","21100015","23740684730"
"066620","국보디자인","17000","17750","750","4.41","400158","6956420750"
"043650","국순당","8830","9390","560","6.34","1320919","11984024620"
"006050","국영지앤엠","1530","1630","100","6.54","10973077","18343681745"
"060480","국일신동","2970","3680","710","23.91","16498775","65093793055"
"078130","국일제지","2615","2710","95","3.63","9155409","23890297120"
"307750","국전약품","7380","8080","700","9.49","71980666","659753532400"
"002720","국제약품","5770","5580","-190","-3.29","11426688","67000981540"
"243870","굿센","15000","15500","500","3.33","2899","45532350"
"035080","그래디언트","18000","19550","1550","8.61","1637175","30038534450"
"204020","그리티","3145","3325","180","5.72","5766675","19031761245"
"083420","그린케미칼","7080","8950","1870","26.41","24555091","220254600770"
"186230","그린플러스","12000","13450","1450","12.08","881992","11188822850"
"014530","극동유화","3615","3775","160","4.43","2450273","8929607335"
"900070","글로벌에스엠","800","779","-21","-2.63","8045186","6393043699"
"204620","글로벌텍스프리","2475","2445","-30","-1.21","4774100","12488203750"
"019660","글로본","2490","2915","425","17.07","6086558","16544765600"
"014280","금강공업","7140","7430","290","4.06","2078642","14641211550"
"014285","금강공업우","12900","13050","150","1.16","26208","334139250"
"053260","금강철강","7120","7060","-60","-0.84","1956724","13516210140"
"008870","금비","71100","71000","-100","-0.14","49926","3735931400"
"001570","금양","5200","10300","5100","98.08","281312946","2429177041690"
"002990","금호건설","8010","8790","780","9.74","1225735","10065412330"
"002995","금호건설우","26550","28800","2250","8.47","6268","168280900"
"011780","금호석유","138000","133500","-4500","-3.26","2369906","298586937500"
"011785","금호석유우","87600","90200","2600","2.97","201223","17023267900"
"214330","금호에이치티","1290","1215","-75","-5.81","26641974","34386419555"
"001210","금호전기","1400","1415","15","1.07","4295686","5891936225"
"073240","금호타이어","3475","3725","250","7.19","5427369","19175253450"
"036190","금화피에스시","29850","30200","350","1.17","54322","1600048750"
"049080","기가레인","1525","1610","85","5.57","10958879","17299527010"
"035460","기산텔레콤","3425","4060","635","18.54","31626666","117894620455"
"092440","기신정기","3485","3750","265","7.60","371114","1336436575"
"000270","기아","76800","80700","3900","5.08","28780260","2324347561256"
"024110","기업은행","9210","9590","380","4.13","20143730","186676520280"
"013700","까뮤이앤씨","1910","2395","485","25.39","74231669","170738075480"
"308100","까스텔바작","9980","11100","1120","11.22","18346939","192666459680"
"004540","깨끗한나라","3505","3700","195","5.56","3472103","12762475080"
"004545","깨끗한나라우","19300","20050","750","3.89","7263","139719400"
"187790","나노","1095","1205","110","10.05","2421714","2817341060"
"286750","나노브릭","2065","2330","265","12.83","5609881","12822301545"
"121600","나노신소재","72100","88500","16400","22.75","4274320","343026690500"
"247660","나노씨엠에스","34500","30950","-3550","-10.29","4702832","165463334500"
"039860","나노엔텍","5440","5590","150","2.76","20761454","129337498440"
"091970","나노캠텍","1610","1610","0","0.00","0","0"
"244880","나눔테크","3035","3075","40","1.32","1345","3987535"
"288490","나라소프트","145","125","-20","-13.79","315649","39899491"
"051490","나라엠앤디","6420","7430","1010","15.73","5640745","40252400800"
"137080","나래나노텍","9110","9060","-50","-0.55","4410486","42240382520"
"190510","나무가","9430","10200","770","8.17","3544660","35823613590"
"242040","나무기술","1790","2055","265","14.80","21813002","47037167855"
"089600","나스미디어","22800","25700","2900","12.72","455352","11153814400"
"293580","나우IB","8550","8580","30","0.35","1359750","12257259010"
"257990","나우코스","5880","7100","1220","20.75","21210","137083670"
"138610","나이벡","24000","24000","0","0.00","1064165","26221386950"
"130580","나이스디앤비","7310","7900","590","8.07","788945","6709730190"
"036800","나이스정보통신","25200","26000","800","3.17","691739","17961360150"
"267320","나인테크","3605","4005","400","11.10","46479353","179571346820"
"001260","남광토건","11350","11550","200","1.76","2039825","22462843940"
"008350","남선알미늄","2130","2265","135","6.34","62411010","141399696055"
"008355","남선알미우","22050","23800","1750","7.94","81168","1903588500"
"004270","남성","2260","2445","185","8.19","2522784","6133340605"
"003920","남양유업","369500","385000","15500","4.19","12558","4659062000"
"003925","남양유업우","199500","213000","13500","6.77","2112","430134000"
"025860","남해화학","9650","10050","400","4.15","9838413","94988083550"
"111710","남화산업","7450","8080","630","8.46","190851","1453864540"
"091590","남화토건","7480","7870","390","5.21","1513825","11961723290"
"168330","내츄럴엔도텍","4265","4880","615","14.42","1047653","5102685830"
"094860","네오리진","717","737","20","2.79","22120748","17343972481"
"253590","네오셈","3430","3315","-115","-3.35","3533062","12081160170"
"212560","네오오토","6050","7470","1420","23.47","6221912","46416477430"
"095660","네오위즈","25900","28100","2200","8.49","7604316","209720259650"
"042420","네오위즈홀딩스","29450","32800","3350","11.38","2314010","74469131850"
"950220","네오이뮨텍","4520","5190","670","14.82","58799554","301806074000"
"311390","네오크레마","13800","14000","200","1.45","1849618","28313080100"
"085910","네오티스","5010","5470","460","9.18","1775885","9235159335"
"092730","네오팜","20150","20400","250","1.24","233019","4769732800"
"290660","네오펙트","2095","2190","95","4.53","1755942","3968766870"
"306620","네온테크","4405","4480","75","1.70","41372017","191536644710"
"153460","네이블","7180","7400","220","3.06","193343","1449537630"
"007390","네이처셀","18950","23100","4150","21.90","23828401","548994830950"
"033640","네패스","19250","20350","1100","5.71","2404627","46880846600"
"330860","네패스아크","28550","29200","650","2.28","846016","24086290400"
"005720","넥센","3470","3640","170","4.90","258280","916669200"
"005725","넥센우","3085","3030","-55","-1.78","88164","257116610"
"002350","넥센타이어","5520","6490","970","17.57","3031880","18835475360"
"002355","넥센타이어1우B","2745","2930","185","6.74","392759","1075580200"
"089140","넥스턴바이오","2785","3340","555","19.93","57061328","194541966470"
"137940","넥스트아이","720","742","22","3.06","5229374","3953358130"
"396270","넥스트칩","14700","11000","-3700","-25.17","16802662","216918901900"
"348210","넥스틴","59000","56000","-3000","-5.08","1413737","85708866600"
"225570","넥슨게임즈","17450","22300","4850","27.79","21024646","435546266050"
"217270","넵튠","11650","15050","3400","29.18","7422422","115071020100"
"251270","넷마블","68700","72000","3300","4.80","4592445","322856621700"
"317860","노드메이슨","7300","8490","1190","16.30","2084","15469890"
"104620","노랑풍선","8230","7750","-480","-5.83","1262825","9540095780"
"090350","노루페인트","8360","9850","1490","17.82","5078382","47538614130"
"090355","노루페인트우","15000","17400","2400","16.00","27114","436854350"
"000320","노루홀딩스","10750","11600","850","7.91","253814","2885692500"
"000325","노루홀딩스우","25500","21500","-4000","-15.69","99935","2213232800"
"194700","노바렉스","29100","32600","3500","12.03","439323","13779316800"
"285490","노바텍","31850","32700","850","2.67","1090341","36715331550"
"229500","노브메타파마","12500","13350","850","6.80","31085","388559850"
"106520","노블엠앤비","3625","3990","365","10.07","6545321","25473220980"
"376930","노을","9230","7400","-1830","-19.83","6224148","49624672930"
"278650","노터스","8250","6770","-1480","-17.94","110971163","827199633050"
"006280","녹십자","177000","172000","-5000","-2.82","697792","123734372000"
"142280","녹십자엠에스","7760","7810","50","0.64","23961167","202191915530"
"234690","녹십자웰빙","8010","8190","180","2.25","1146867","9426603440"
"005250","녹십자홀딩스","19950","20650","700","3.51","2037594","42594731500"
"005257","녹십자홀딩스2우","56500","56400","-100","-0.18","130602","8080284400"
"065560","녹원씨엔아이","5770","5770","0","0.00","0","0"
"004370","농심","283000","296500","13500","4.77","472377","134397139000"
"072710","농심홀딩스","68400","68300","-100","-0.15","46113","3111923000"
"054050","농우바이오","9850","10150","300","3.05","632432","6339859900"
"069140","누리플랜","5840","5700","-140","-2.40","435968","2491459350"
"040160","누리플렉스","6840","6400","-440","-6.43","3333700","22768207280"
"332290","누보","2795","2310","-485","-17.35","13009416","31916657110"
"126870","뉴로스","2230","2230","0","0.00","0","0"
"060260","뉴보텍","1120","1320","200","17.86","52531143","65896271020"
"012340","뉴인텍","2970","4005","1035","34.85","81589473","322766803040"
"214870","뉴지랩파마","9080","13950","4870","53.63","9695064","112058825230"
"270870","뉴트리","13100","13450","350","2.67","965508","12455831550"
"144960","뉴파워프라즈마","4060","4565","505","12.44","1796244","8151480440"
"085670","뉴프렉스","4305","5170","865","20.09","10826023","53202418560"
"119860","다나와","17350","18900","1550","8.93","493565","8938107750"
"064260","다날","7170","7710","540","7.53","40915958","309446718960"
"093640","다믈멀티미디어","3720","4235","515","13.84","958580","3944720630"
"340360","다보링크","1235","1365","130","10.53","3752264","4826695775"
"039560","다산네트웍스","5670","5930","260","4.59","1079732","6259250390"
"058730","다스코","5500","6460","960","17.45","25951564","147029137555"
"298870","다올인베스트먼트","3180","3330","150","4.72","14645250","50958261100"
"030210","다올투자증권","4285","4450","165","3.85","2199809","9552260635"
"023590","다우기술","17800","18900","1100","6.18","712194","13108298250"
"032190","다우데이타","10250","11700","1450","14.15","1373784","14861110110"
"323350","다원넥스뷰","54000","47000","-7000","-12.96","1057","53901900"
"068240","다원시스","22550","23800","1250","5.54","3513573","79179124750"
"145210","다이나믹디자인","4735","4695","-40","-0.84","204518","947910150"
"271850","다이오진","1690","1690","0","0.00","0","0"
"019680","대교","2920","3050","130","4.45","1320339","4039883005"
"019685","대교우B","2175","2270","95","4.37","420174","994061800"
"006370","대구백화점","11250","10650","-600","-5.33","59458","638450400"
"008060","대덕","6220","6690","470","7.56","1251694","8192590010"
"00806K","대덕1우","9200","9200","0","0.00","34624","318723790"
"353200","대덕전자","28150","27400","-750","-2.66","15101401","432751208550"
"35320K","대덕전자1우","12300","12350","50","0.41","114586","1428337400"
"000490","대동","11450","12150","700","6.11","6933500","83691902200"
"178600","대동고려삼","4200","3840","-360","-8.57","25270","89541175"
"020400","대동금속","9060","10250","1190","13.13","2952809","30194029190"
"008830","대동기어","7200","8240","1040","14.44","17438606","151186186100"
"048470","대동스틸","4980","5710","730","14.66","9646016","56286838025"
"008110","대동전자","6450","13650","7200","111.63","51559882","568939477100"
"004780","대륙제관","4615","4820","205","4.44","7703989","38703397380"
"005750","대림B&Co","5000","6180","1180","23.60","5502056","33310327575"
"017650","대림제지","8640","8960","320","3.70","276247","2451139880"
"006570","대림통상","3895","3915","20","0.51","297086","1077620585"
"007720","대명소노시즌","852","900","48","5.63","3738593","3232516774"
"389260","대명에너지","14700","24000","9300","63.27","23461468","456730292650"
"317850","대모","8330","8010","-320","-3.84","6636664","53504291650"
"290670","대보마그네틱","41350","48250","6900","16.69","1165774","53483018500"
"078140","대봉엘에스","7420","8420","1000","13.48","16292909","152103579880"
"001680","대상","21400","23650","2250","10.51","2723264","61019915500"
"001685","대상우","16050","17000","950","5.92","96479","1577446350"
"084690","대상홀딩스","7990","8810","820","10.26","1031840","8571276170"
"084695","대상홀딩스우","10000","10400","400","4.00","306857","3157409290"
"036480","대성미생물","12300","13050","750","6.10","154516","1947963000"
"128820","대성산업","5110","5090","-20","-0.39","10571690","53365205755"
"117580","대성에너지","10750","13850","3100","28.84","30091958","378865534850"
"025440","대성엘텍","884","935","51","5.77","25442087","22784669250"
"027830","대성창투","3000","3455","455","15.17","152592287","652316741365"
"104040","대성파인텍","1625","1965","340","20.92","44268947","89599472755"
"016710","대성홀딩스","75500","86000","10500","13.91","2805463","228836299800"
"387310","대신밸런스제10호스팩","2265","2320","55","2.43","367728","834898060"
"397500","대신밸런스제11호스팩","2680","2680","0","0.00","0","0"
"020180","대신정보통신","1150","1380","230","20.00","42097968","58222182865"
"003540","대신증권","14900","15350","450","3.02","843857","12663366450"
"003547","대신증권2우B","13300","13750","450","3.38","268321","3577728600"
"003545","대신증권우","13550","14300","750","5.54","838219","11546540800"
"045390","대아티아이","3385","3715","330","9.75","23073350","84773549990"
"009190","대양금속","3560","3950","390","10.96","10269325","39546449385"
"108380","대양전기공업","12300","13500","1200","9.76","574069","7079682750"
"006580","대양제지","3260","3260","0","0.00","0","0"
"014160","대영포장","1650","1790","140","8.48","22507681","40609037455"
"047040","대우건설","5640","5490","-150","-2.66","42317014","224522110210"
"009320","대우부품","1810","2145","335","18.51","8285793","18091507780"
"042660","대우조선해양","20400","21550","1150","5.64","10775984","216694726450"
"003090","대웅","27250","27250","0","0.00","752334","21070001600"
"069620","대웅제약","179500","179500","0","0.00","1127344","206968733500"
"007680","대원","8840","8870","30","0.34","312351","2710373810"
"000430","대원강업","2825","3210","385","13.63","5241263","17831487580"
"048910","대원미디어","12350","14600","2250","18.22","2262020","31236876200"
"005710","대원산업","5280","5460","180","3.41","253900","1350262430"
"006340","대원전선","1500","1570","70","4.67","7402776","11228865465"
"006345","대원전선우","2630","2795","165","6.27","102176","268669250"
"003220","대원제약","17500","18200","700","4.00","9847795","182894976000"
"024890","대원화성","2450","3240","790","32.24","73540794","237656044520"
"290380","대유","4495","4625","130","2.89","16474660","79403213720"
"002880","대유에이텍","841","890","49","5.83","6329997","5430784167"
"290120","대유에이피","5470","6320","850","15.54","898337","5427155530"
"000300","대유플러스","869","953","84","9.67","9323018","8522562686"
"120240","대정화금","18100","18750","650","3.59","1080769","20048320100"
"003310","대주산업","3310","2655","-655","-19.79","35148071","102362144190"
"114920","대주이엔티","1820","2390","570","31.32","1535","2711950"
"078600","대주전자재료","65600","87300","21700","33.08","4343983","332571627400"
"012800","대창","1400","1545","145","10.36","7215574","10425733555"
"015230","대창단조","5240","5490","250","4.77","3902154","19909648205"
"096350","대창솔루션","433","423","-10","-2.31","19527768","8225021395"
"140520","대창스틸","3270","3480","210","6.42","1227264","4078950490"
"131220","대한과학","7400","10100","2700","36.49","25727866","264227738610"
"010170","대한광통신","2200","3270","1070","48.64","30154535","84550756150"
"060900","대한그린파워","735","875","140","19.05","71794233","59711115880"
"054670","대한뉴팜","10200","10800","600","5.88","1278083","13349750820"
"001070","대한방직","49700","52600","2900","5.84","471738","23054163700"
"023910","대한약품","26100","27000","900","3.45","97153","2618395200"
"006650","대한유화","128500","129500","1000","0.78","711079","88578589500"
"001440","대한전선","1825","1850","25","1.37","223632208","386585173955"
"084010","대한제강","15300","16600","1300","8.50","990976","15571209700"
"001790","대한제당","3300","3000","-300","-9.09","16861085","52976393625"
"001795","대한제당우","3215","2930","-285","-8.86","4571762","14274058440"
"001130","대한제분","145000","142500","-2500","-1.72","70895","9889106500"
"003490","대한항공","25150","25900","750","2.98","30898784","777542950500"
"003495","대한항공우","33350","32550","-800","-2.40","104682","3476557400"
"005880","대한해운","2440","2495","55","2.25","19385536","45926779820"
"003830","대한화섬","106000","110500","4500","4.25","11999","1256640000"
"016090","대현","2100","2250","150","7.14","3654585","7776903535"
"069460","대호에이엘","2500","2140","-360","-14.40","60807576","135407992360"
"021040","대호특수강","632","743","111","17.56","1877812","1301300712"
"021045","대호특수강우","1320","1320","0","0.00","177731","237663400"
"067080","대화제약","7150","8100","950","13.29","843044","6390265970"
"298540","더네이쳐홀딩스","29600","28850","-750","-2.53","584807","17290209550"
"192080","더블유게임즈","40900","40000","-900","-2.20","1197387","48717145500"
"299170","더블유에스아이","2040","2350","310","15.20","1230194","2719326370"
"012510","더존비즈온","36100","33200","-2900","-8.03","2357639","79113796450"
"302920","더콘텐츠온","9990","9990","0","0.00","72","684530"
"213420","덕산네오룩스","31200","31350","150","0.48","1991644","63032745050"
"317330","덕산테코피아","15650","16000","350","2.24","1068813","16793347800"
"077360","덕산하이메탈","7280","7090","-190","-2.61","5373030","40228510120"
"004830","덕성","6260","6200","-60","-0.96","2407118","15133468950"
"004835","덕성우","7260","7310","50","0.69","246980","1815360630"
"090410","덕신하우징","2240","2500","260","11.61","40053534","93499126475"
"024900","덕양산업","2480","2780","300","12.10","1432855","3813256620"
"263600","덕우전자","6270","7380","1110","17.70","11190270","82518293790"
"194480","데브시스터즈","45000","45450","450","1.00","3095868","149489980200"
"348840","데이드림엔터","10950","10500","-450","-4.11","0","0"
"263800","데이타솔루션","5490","5630","140","2.55","4509532","25073246360"
"199150","데이터스트림즈","11450","10250","-1200","-10.48","6231","62688350"
"206560","덱스터","14150","16350","2200","15.55","17543026","280622724700"
"261200","덴티스","8840","10000","1160","13.12","2156572","20479805790"
"145720","덴티움","84200","101000","16800","19.95","3386658","292530987700"
"227420","도부마스크","4080","3840","-240","-5.88","152444","570933720"
"067990","도이치모터스","8380","8210","-170","-2.03","7154341","59490980100"
"002150","도화엔지니어링","9450","9310","-140","-1.48","10183084","93785267790"
"006620","동구바이오제약","6520","6840","320","4.91","2027154","13753062150"
"100130","동국S&C","5530","7110","1580","28.57","59043364","399394109750"
"005160","동국산업","2855","3070","215","7.53","1157796","3385761700"
"075970","동국알앤에스","3790","4190","400","10.55","17260894","72935776210"
"001230","동국제강","12750","14050","1300","10.20","9172716","117930848850"
"086450","동국제약","19850","19850","0","0.00","1227333","23823242500"
"023450","동남합성","58400","59000","600","1.03","18820","1096216400"
"004140","동방","2780","2960","180","6.47","4978124","14546940770"
"099410","동방선기","3125","3460","335","10.72","2290116","7454542965"
"007590","동방아그로","6900","7250","350","5.07","267199","1876873500"
"005960","동부건설","10850","11850","1000","9.22","799864","8652526050"
"005965","동부건설우","25700","28500","2800","10.89","8760","225298950"
"026960","동서","25700","25500","-200","-0.78","1075082","26878905050"
"002210","동성제약","7860","8050","190","2.42","654724","5172613440"
"102260","동성케미컬","4000","4470","470","11.75","627134","2662943655"
"033500","동성화인텍","10750","12400","1650","15.35","7434472","86584581950"
"025950","동신건설","20250","22700","2450","12.10","2680939","58636674150"
"000640","동아쏘시오홀딩스","102500","108000","5500","5.37","166239","17306990000"
"170900","동아에스티","58900","59600","700","1.19","113194","6909258100"
"088130","동아엘텍","7020","7420","400","5.70","197067","1416685400"
"028100","동아지질","16650","18650","2000","12.01","1045241","18525993900"
"282690","동아타이어","11600","12050","450","3.88","150964","1765086150"
"041930","동아화성","8060","9270","1210","15.01","2689786","23603100390"
"001520","동양","1150","1195","45","3.91","6670285","7823871705"
"001527","동양2우B","12400","13050","650","5.24","27131","343917250"
"084670","동양고속","15700","16600","900","5.73","16822","264728000"
"082640","동양생명","5600","5500","-100","-1.79","1567072","8509806880"
"060380","동양에스텍","2435","2760","325","13.35","13177362","36669608285"
"001525","동양우","6300","6340","40","0.63","51081","322064030"
"079960","동양이엔피","13600","14900","1300","9.56","459724","6588726250"
"008970","동양철관","1085","1170","85","7.83","34118048","38164696390"
"228340","동양파일","3625","3915","290","8.00","784109","2891631530"
"092780","동양피스톤","4880","5320","440","9.02","1009437","5086761760"
"088910","동우팜투테이블","2765","2925","160","5.79","2356735","6544744395"
"094170","동운아나텍","8490","8330","-160","-1.88","9448556","82028685280"
"049770","동원F&B","153500","163500","10000","6.51","62861","9895693500"
"013120","동원개발","4200","4215","15","0.36","2106102","8754032710"
"018500","동원금속","864","904","40","4.63","1783366","1583603172"
"006040","동원산업","214000","230000","16000","7.48","57618","12878677500"
"030720","동원수산","9250","10100","850","9.19","1796630","17823868260"
"014820","동원시스템즈","51900","58000","6100","11.75","642760","35491448750"
"014825","동원시스템즈우","31750","34150","2400","7.56","2681","87377700"
"163560","동일고무벨트","7930","7140","-790","-9.96","1994116","14548948300"
"109860","동일금속","18200","20150","1950","10.71","1213035","22876171400"
"032960","동일기연","11700","13250","1550","13.25","5041737","70988978550"
"004890","동일산업","169000","180000","11000","6.51","93190","16276826500"
"002690","동일제강","3245","3365","120","3.70","2533092","8179151310"
"023790","동일철강","2705","2790","85","3.14","689928","1856380065"
"005290","동진쎄미켐","33450","34250","800","2.39","15872603","557545166700"
"025900","동화기업","60900","73200","12300","20.20","1124374","73698098000"
"000020","동화약품","10500","10600","100","0.95","3305052","35912681450"
"000150","두산","68100","81300","13200","19.38","1653503","117279885000"
"000157","두산2우B","93500","101500","8000","8.56","33096","3173720400"
"241560","두산밥캣","29100","32550","3450","11.86","6493392","199999660950"
"034020","두산에너빌리티","18550","20300","1750","9.43","79321669","1469708924350"
"000155","두산우","45600","52200","6600","14.47","55539","2635872800"
"131970","두산테스나","30750","29300","-1450","-4.72","2949512","87357324750"
"336260","두산퓨얼셀","30000","38800","8800","29.33","8666228","284293099600"
"33626K","두산퓨얼셀1우","9460","13250","3790","40.06","1069898","13064002920"
"33626L","두산퓨얼셀2우B","12450","16150","3700","29.72","653519","9775383400"
"016740","두올","2760","2960","200","7.25","2451102","7115474970"
"073190","듀오백","2215","2770","555","25.06","1070131","2756556795"
"176750","듀켐바이오","7030","6700","-330","-4.69","136105","914238250"
"030350","드래곤플라이","1885","2090","205","10.88","29704133","61323877690"
"203650","드림시큐리티","3110","3370","260","8.36","11679016","39398488350"
"223250","드림씨아이에스","14050","14250","200","1.42","751989","10611256350"
"060570","드림어스컴퍼니","3300","3685","385","11.67","1030538","3568272175"
"192650","드림텍","9570","9250","-320","-3.34","3614092","33584789670"
"217620","디딤","1375","1385","10","0.73","8854844","13031412477"
"016670","디모아","973","973","0","0.00","0","0"
"187870","디바이스이엔지","17200","18400","1200","6.98","219539","3976433550"
"066670","디스플레이텍","5950","6180","230","3.87","6391531","40663311770"
"024090","디씨엠","22350","20450","-1900","-8.50","1069703","22789396200"
"003160","디아이","5910","6220","310","5.25","1595238","10016817520"
"092200","디아이씨","4125","4485","360","8.73","2532978","10935405880"
"110990","디아이티","7170","7070","-100","-1.39","1600772","11966236250"
"078590","디아크","2380","2380","0","0.00","0","0"
"263690","디알젬","8710","9640","930","10.68","176455","1648402750"
"214680","디알텍","1525","1655","130","8.52","9290872","14381160135"
"377190","디앤디플랫폼리츠","4410","4650","240","5.44","2763826","11914240855"
"263720","디앤씨미디어","21700","23000","1300","5.99","956368","22096825950"
"376300","디어유","34750","37250","2500","7.19","3727769","140812243350"
"141020","디에스앤엘","1335","1335","0","0.00","0","0"
"109740","디에스케이","5190","5780","590","11.37","344186","1906957230"
"196490","디에이테크놀로지","3930","4680","750","19.08","4524093","19160198365"
"066900","디에이피","3310","3495","185","5.59","867164","2988558275"
"180400","디엑스앤브이엑스","7740","7740","0","0.00","0","0"
"127120","디엔에이링크","3975","3940","-35","-0.88","1542922","5941001490"
"092070","디엔에프","14550","14000","-550","-3.78","1075232","15835714600"
"039840","디오","26700","27650","950","3.56","1041096","28261764200"
"013570","디와이","6850","7360","510","7.45","6525523","46380108730"
"219550","디와이디","1435","1540","105","7.32","25556914","39187090645"
"310870","디와이씨","1450","1585","135","9.31","3862018","5963194015"
"210540","디와이파워","12650","12600","-50","-0.40","1321221","15671567800"
"104460","디와이피엔에프","38500","40350","1850","4.81","481642","18425435550"
"079810","디이엔티","6780","7930","1150","16.96","1361614","10182820990"
"113810","디젠스","1100","1245","145","13.18","34898942","45191444864"
"043360","디지아이","3600","3430","-170","-4.72","1402713","4986270250"
"197140","디지캡","4045","4125","80","1.98","1246032","4966750495"
"068930","디지털대성","6940","7910","970","13.98","894713","6460069770"
"033130","디지틀조선","2180","2325","145","6.65","1975414","4466123935"
"105740","디케이락","9440","12050","2610","27.65","1475712","15647729800"
"263020","디케이앤디","2955","3160","205","6.94","1027165","3167971185"
"290550","디케이티","9240","11000","1760","19.05","1741297","18321643800"
"187220","디티앤씨","5040","5640","600","11.90","2359069","13124677180"
"163430","디피코","7620","7620","0","0.00","0","0"
"131180","딜리","1660","1665","5","0.30","1368974","2250597325"
"315640","딥노이드","8180","8700","520","6.36","1263449","11182109240"
"317120","라닉스","6200","6750","550","8.87","1457625","9692327200"
"042510","라온시큐어","2745","3055","310","11.29","11331015","33686879770"
"232680","라온테크","14700","14650","-50","-0.34","2557769","37699531950"
"300120","라온피플","7132","5800","-1332","-18.68","7013790","65874465260"
"171120","라이온켐텍","7600","8960","1360","17.89","11298215","105128835030"
"069540","라이트론","3880","4250","370","9.54","1667572","6587555305"
"285770","라이프사이언스테크놀로지","1390","1390","0","0.00","0","0"
"347700","라이프시맨틱스","5700","5950","250","4.39","2178340","13212262450"
"214260","라파스","38600","40800","2200","5.70","613872","24845800000"
"403360","라피치","13000","13500","500","3.85","1488","18975600"
"115390","락앤락","7810","8070","260","3.33","4576241","39975528090"
"200350","래몽래인","16100","21900","5800","36.02","4574024","89797898200"
"171010","램테크놀러지","6190","7380","1190","19.22","5720505","40684447390"
"084650","랩지노믹스","7590","8090","500","6.59","93339059","824728783230"
"217500","러셀","3490","3820","330","9.46","10681266","40843384835"
"092590","럭스피아","2350","2085","-265","-11.28","25943","48196140"
"141080","레고켐바이오","47950","49950","2000","4.17","5253871","245499964950"
"060300","레드로버","1830","1830","0","0.00","0","0"
"038390","레드캡투어","18350","20350","2000","10.90","434779","8858797350"
"294140","레몬","5920","5420","-500","-8.45","12069938","68699094290"
"228670","레이","23950","23050","-900","-3.76","2948568","71118530600"
"228850","레이언스","9500","10800","1300","13.68","960508","10044594290"
"412350","레이저쎌","14750","12300","-2450","-16.61","11649708","150204675840"
"281740","레이크머티리얼즈","4450","4710","260","5.84","9351995","45124149425"
"277810","레인보우로보틱스","23750","28100","4350","18.32","10602996","295785861350"
"179720","렌딩머신","5600","5100","-500","-8.93","165","967400"
"215100","로보로보","7300","7780","480","6.58","19361586","150195046380"
"090360","로보스타","18500","20650","2150","11.62","2215007","44148580350"
"238500","로보쓰리","798","720","-78","-9.77","971148","687364840"
"108490","로보티즈","18150","21700","3550","19.56","8745189","186848977750"
"900260","로스웰","307","353","46","14.98","213859755","79076810218"
"223220","로지스몬","598","590","-8","-1.34","3159","1509486"
"067730","로지시스","4950","5860","910","18.38","6696325","40653527350"
"071280","로체시스템즈","6020","6380","360","5.98","2325316","14544167790"
"032350","롯데관광개발","11900","11900","0","0.00","8678579","98725429850"
"089860","롯데렌탈","36650","38150","1500","4.09","1520856","58464405900"
"330590","롯데리츠","5290","5080","-210","-3.97","5511163","27861474293"
"000400","롯데손해보험","1615","1705","90","5.57","3680876","6156621785"
"023530","롯데쇼핑","99000","101500","2500","2.53","2142661","202298697900"
"004000","롯데정밀화학","68800","68600","-200","-0.29","3407182","224060532900"
"286940","롯데정보통신","26350","27600","1250","4.74","552949","14920080700"
"280360","롯데제과","115500","122500","7000","6.06","247931","29293519500"
"004990","롯데지주","35050","38800","3750","10.70","3804069","136379082450"
"00499K","롯데지주우","47600","50700","3100","6.51","20902","1014178100"
"005300","롯데칠성","174000","166500","-7500","-4.31","893751","151830153000"
"005305","롯데칠성우","71900","71200","-700","-0.97","25649","1824435800"
"011170","롯데케미칼","180000","182500","2500","1.39","2375938","412424954500"
"071840","롯데하이마트","16850","16650","-200","-1.19","412490","6961126100"
"038060","루멘스","1135","1190","55","4.85","3335361","3897344270"
"162120","루켄테크놀러지스","4800","5100","300","6.25","42518","203993190"
"253610","루트락","2395","2290","-105","-4.38","20701","42295815"
"085370","루트로닉","17900","20700","2800","15.64","7335957","140402111550"
"08537M","루트로닉3우C","25200","28850","3650","14.48","4168","107938600"
"060240","룽투코리아","4765","5280","515","10.81","32340202","173661735145"
"058470","리노공업","134200","131200","-3000","-2.24","1016814","133386840564"
"039980","리노스","1030","971","-59","-5.73","7484114","7114927337"
"019570","리더스 기술투자","400","387","-13","-3.25","12887539","5101466241"
"016100","리더스코스메틱","2820","2630","-190","-6.74","347035","934854030"
"012700","리드코프","8080","8420","340","4.21","2700478","22432689940"
"302550","리메드","13400","13550","150","1.12","458887","6406228200"
"377450","리파인","11500","11000","-500","-4.35","855502","9482142900"
"277070","린드먼아시아","4720","5060","340","7.20","4352301","22642504025"
"042500","링네트","4550","5020","470","10.33","5081582","27520855105"
"219420","링크제니시스","5680","7020","1340","23.59","9647469","68457547840"
"027740","마니커","1585","1415","-170","-10.73","10180119","14589902815"
"195500","마니커에프앤지","3915","4095","180","4.60","4041308","16589728915"
"357430","마스턴프리미어리츠","5010","5010","0","0.00","336286","1664800630"
"222810","마이더스AI","2070","1570","-500","-24.15","58937265","118551688235"
"305090","마이크로디지탈","5140","5330","190","3.70","1655249","9506204920"
"098120","마이크로컨텍솔","6300","6440","140","2.22","1262995","8139284250"
"147760","마이크로프랜드","4550","4940","390","8.57","396343","1935891615"
"377480","마인즈랩","16250","17050","800","4.92","1450754","24458743250"
"038290","마크로젠","26200","26850","650","2.48","318032","8344388000"
"204320","만도","48500","56200","7700","15.88","7271777","393678025100"
"001080","만호제강","22300","27600","5300","23.77","198513","4821842650"
"267980","매일유업","59100","59200","100","0.17","230682","13507590900"
"005990","매일홀딩스","9230","8900","-330","-3.58","102394","918914630"
"127160","매직마이크로","282","282","0","0.00","0","0"
"093520","매커스","7940","8980","1040","13.10","3228078","28389434290"
"377030","맥스트","17850","18850","1000","5.60","11711496","218474109350"
"088980","맥쿼리인프라","12200","12900","700","5.74","20358074","252917763900"
"094800","맵스리얼티1","4520","4510","-10","-0.22","796914","3536338160"
"100590","머큐리","6430","6690","260","4.04","380173","2495006780"
"067280","멀티캠퍼스","38100","40250","2150","5.64","161750","6546993200"
"072870","메가스터디","11200","11250","50","0.45","1501300","17371705550"
"215200","메가스터디교육","77400","85300","7900","10.21","1479620","127021853300"
"133750","메가엠디","2670","3125","455","17.04","57510648","210468435060"
"235980","메드팩토","26400","32250","5850","22.16","5299581","160632244300"
"200580","메디쎄이","14000","16400","2400","17.14","82733","1189745900"
"041920","메디아나","5100","5060","-40","-0.78","12369505","68723206405"
"233250","메디안디노스틱","32600","32700","100","0.31","267","8364050"
"014100","메디앙스","4160","4085","-75","-1.80","561506","2266702940"
"236340","메디젠휴먼케어","9400","9080","-320","-3.40","4828","43737760"
"054180","메디콕스","5410","8280","2870","53.05","16405638","124505499180"
"086900","메디톡스","113800","109900","-3900","-3.43","478011","54140434100"
"078160","메디포스트","19450","21200","1750","9.00","3569165","76650729050"
"065650","메디프론","1595","1730","135","8.46","2100313","3565819050"
"138040","메리츠금융지주","26600","29100","2500","9.40","3002204","78304390050"
"008560","메리츠증권","4665","4875","210","4.50","16072860","74391210570"
"000060","메리츠화재","32550","37300","4750","14.59","3584640","120610623300"
"021880","메이슨캐피탈","566","474","-92","-16.25","28406437","14291804703"
"140410","메지온","19600","18550","-1050","-5.36","10109832","212832561300"
"241770","메카로","10550","11500","950","9.00","194211","2100239510"
"090370","메타랩스","871","729","-142","-16.30","9090708","6982433706"
"059210","메타바이오메드","2270","2450","180","7.93","2213691","5291935755"
"058110","멕아이씨에스","6090","6390","300","4.93","29568187","211550547130"
"096640","멜파스","1495","1495","0","0.00","0","0"
"017180","명문제약","3270","3450","180","5.50","1306912","4387352580"
"257370","명성티엔에스","9210","9210","0","0.00","0","0"
"009900","명신산업","16650","22350","5700","34.23","11905489","240191201050"
"267060","명진홀딩스","181","181","0","0.00","0","0"
"012690","모나리자","3495","3480","-15","-0.43","6969983","24162899540"
"005360","모나미","4165","3800","-365","-8.76","12795829","48020646280"
"080420","모다이노칩","3405","3405","0","0.00","5214871","17641219010"
"080160","모두투어","15650","16100","450","2.88","1620899","24568760400"
"204210","모두투어리츠","4560","4875","315","6.91","89919","423268470"
"100030","모바일리더","20750","21300","550","2.65","197826","4088123350"
"087260","모바일어플라이언스","3165","3415","250","7.90","21135150","73389964280"
"101330","모베이스","2920","3185","265","9.08","2224780","6888877930"
"012860","모베이스전자","1395","1510","115","8.24","24139942","36446315785"
"363260","모비데이즈","1515","1490","-25","-1.65","20618204","32760594985"
"348030","모비릭스","15100","18350","3250","21.52","22771373","421019065350"
"250060","모비스","1740","2440","700","40.23","44966628","110638915435"
"288980","모아데이타","3843","2375","-1468","-38.20","64645465","411801425310"
"033200","모아텍","5610","9650","4040","72.01","27210435","250338472430"
"009680","모토닉","8480","8510","30","0.35","241153","2068266560"
"118990","모트렉스","10850","12000","1150","10.60","27736395","329304917640"
"006920","모헨즈","3960","4580","620","15.66","5163823","23028334715"
"009580","무림P&P","3970","4735","765","19.27","6951946","30301208280"
"001810","무림SP","2690","3010","320","11.90","11833318","35920124860"
"009200","무림페이퍼","2590","2740","150","5.79","21865644","61960318105"
"135160","무송지오씨","2660","2595","-65","-2.44","136763","346585525"
"322970","무진메디","5010","4990","-20","-0.40","54988","271801745"
"033920","무학","6680","7010","330","4.94","2347707","16523383920"
"008420","문배철강","3620","3890","270","7.46","3745502","14252854795"
"279600","미디어젠","10450","9910","-540","-5.17","172126","1713901090"
"095500","미래나노텍","6030","9030","3000","49.75","81406665","685368803740"
"025560","미래산업","10100","11300","1200","11.88","578929","6307695750"
"218150","미래생명자원","6500","5930","-570","-8.77","16808617","105974290090"
"007120","미래아이앤지","314","348","34","10.83","47011674","17193731559"
"396690","미래에셋글로벌리츠","4775","4890","115","2.41","993127","4680792350"
"353490","미래에셋대우스팩 5호","2150","2120","-30","-1.40","2888725","6548764440"
"328380","미래에셋대우스팩3호","2130","2255","125","5.87","19782427","48158855235"
"357250","미래에셋맵스리츠","4275","4405","130","3.04","668149","2843953880"
"100790","미래에셋벤처투자","5650","6160","510","9.03","2160629","12906275470"
"412930","미래에셋비전스팩1호","2150","2125","-25","-1.16","732986","1562875150"
"085620","미래에셋생명","3115","3145","30","0.96","1099393","3359781660"
"006800","미래에셋증권","6470","6680","210","3.25","22400057","143111710310"
"00680K","미래에셋증권2우B","3785","3940","155","4.10","2356619","9023824990"
"006805","미래에셋증권우","4350","4885","535","12.30","186082","842892655"
"208890","미래엔에듀파트너","1485","1300","-185","-12.46","1315","1618195"
"049950","미래컴퍼니","19550","21850","2300","11.76","475341","9812493050"
"207760","미스터블루","5440","6310","870","15.99","4439665","28011414660"
"002840","미원상사","175000","179000","4000","2.29","30661","5482598500"
"268280","미원에스씨","198000","193000","-5000","-2.53","30782","5964773000"
"107590","미원홀딩스","132500","136500","4000","3.02","10679","1418537500"
"134380","미원화학","66100","66800","700","1.06","5926","391732200"
"003650","미창석유","81600","82600","1000","1.23","9726","781747200"
"059090","미코","8190","9100","910","11.11","1721113","14968106570"
"214610","미코바이오메드","12200","11200","-1000","-8.20","76979603","1024734196950"
"201490","미투온","4425","4870","445","10.06","4214575","20160026360"
"950190","미투젠","16300","15950","-350","-2.15","840348","14136802000"
"155900","바다로19호","3340","3345","5","0.15","452359","1512957255"
"206640","바디텍메드","12950","12350","-600","-4.63","6069940","84787873000"
"018700","바른손","2695","3030","335","12.43","27390662","83096518510"
"035620","바른손이앤에이","1055","1160","105","9.95","7310916","8243595970"
"064520","바른전자","7000","5520","-1480","-21.14","1754319","9835080540"
"053030","바이넥스","15100","15350","250","1.66","6638941","100700095200"
"301300","바이브컴퍼니","30500","32550","2050","6.72","476347","14935830700"
"064550","바이오니아","34150","33300","-850","-2.49","44172684","1656796209350"
"314930","바이오다인","27200","27950","750","2.76","233013","6555374750"
"208710","바이오로그디바이스","1430","1315","-115","-8.04","23374096","33798426930"
"086820","바이오솔루션","15050","15050","0","0.00","749692","11573771000"
"038460","바이오스마트","4000","4365","365","9.13","12558670","58577474865"
"281310","바이오시네틱스","7600","7600","0","0.00","0","0"
"251120","바이오에프디엔씨","24200","23350","-850","-3.51","1238211","28059404750"
"266470","바이오인프라생명과학","2110","1600","-510","-24.17","233277","419709040"
"086040","바이오톡스텍","7660","8370","710","9.27","16394166","145059863910"
"199290","바이오프로테크","1085","1060","-25","-2.30","5325","5150761"
"099430","바이오플러스","30500","31650","1150","3.77","13899619","439428490293"
"032980","바이온","1350","1215","-135","-10.00","3231798","3765846255"
"222160","바이옵트로","6520","6590","70","1.07","1984207","13402554320"
"308080","바이젠셀","9310","9520","210","2.26","5216660","51018938990"
"043150","바텍","30350","35250","4900","16.14","1023923","33779870300"
"323990","박셀바이오","40400","65200","24800","61.39","36367771","2207643349250"
"003610","방림","2925","3735","810","27.69","5420898","17681821160"
"267790","배럴","7940","7830","-110","-1.39","913483","7289181040"
"001340","백광산업","4290","4740","450","10.49","20390541","91493689080"
"046310","백금T&A","2830","3015","185","6.54","1489188","4213868350"
"035150","백산","9310","10100","790","8.49","6318948","62626907480"
"066410","버킷스튜디오","2005","3185","1180","58.85","609641590","1707731135805"
"002410","범양건영","4650","5400","750","16.13","33328099","172708566295"
"382900","범한퓨얼셀","33900","33500","-400","-1.18","8151323","256397755400"
"206400","베노홀딩스","3405","3455","50","1.47","1816213","6383534310"
"019010","베뉴지","2295","2250","-45","-1.96","9070362","20259461335"
"322190","베른","553","664","111","20.07","65822","36941956"
"177350","베셀","6790","7950","1160","17.08","21143706","158859725280"
"299910","베스파","3165","3165","0","0.00","0","0"
"096300","베트남개발1","205","208","3","1.46","1244301","256507180"
"007210","벽산","2735","2960","225","8.23","12020820","34132310890"
"225530","보광산업","6610","7050","440","6.66","19033747","132191974790"
"250000","보라티알","12000","12950","950","7.92","2808917","36681937000"
"002760","보락","1695","1765","70","4.13","3759802","6567041710"
"003850","보령","10350","11150","800","7.73","2855329","31088135800"
"310210","보로노이","48000","41250","-6750","-14.06","9787035","417441471350"
"006910","보성파워텍","5550","5710","160","2.88","33164403","178676682710"
"000890","보해양조","726","774","48","6.61","6379990","4773145403"
"226340","본느","1680","1745","65","3.87","2407297","4193787485"
"206950","볼빅","2950","3200","250","8.47","5849","18506740"
"003000","부광약품","8670","9730","1060","12.23","40266884","390799190000"
"001270","부국증권","21250","22600","1350","6.35","23332","496863600"
"001275","부국증권우","20200","20200","0","0.00","20624","412777950"
"026940","부국철강","3610","3980","370","10.25","2451840","9243350615"
"014470","부방","2250","2330","80","3.56","3142789","7171299660"
"011390","부산산업","86600","89000","2400","2.77","88485","7708749000"
"005030","부산주공","890","818","-72","-8.09","65917056","55295932605"
"008470","부스타","5200","5400","200","3.85","262537","1374123640"
"338220","뷰노","8120","7760","-360","-4.43","2137763","16651193390"
"100120","뷰웍스","34650","43200","8550","24.68","854434","34414231400"
"337930","브랜드엑스코퍼레이션","7280","8170","890","12.23","2065352","16336877890"
"099390","브레인즈컴퍼니","8520","8840","320","3.76","736371","6653645990"
"064480","브리지텍","4845","5490","645","13.31","1558962","8024180430"
"288330","브릿지바이오테라퓨틱스","9080","12700","3620","39.87","3336665","39664062440"
"365900","브이씨","12600","10550","-2050","-16.27","3013254","35222482450"
"251630","브이원텍","7400","7810","410","5.54","882728","6822237540"
"018290","브이티지엠피","5270","5470","200","3.80","3407704","18628901440"
"044480","블루베리 NFT","2455","2185","-270","-11.00","17653383","42904168535"
"033560","블루콤","9880","9720","-160","-1.62","374190","3644619140"
"191600","블루탑","6930","9670","2740","39.54","1003","7706250"
"369370","블리츠웨이","2810","3105","295","10.50","5758372","16966162250"
"126340","비나텍","41450","45650","4200","10.13","621815","25831687450"
"121800","비덴트","8920","10600","1680","18.83","166412585","1949888422990"
"148140","비디아이","640","640","0","0.00","0","0"
"082800","비보존 헬스케어","959","1000","41","4.28","8390765","8417527887"
"318410","비비씨","10700","11250","550","5.14","562892","6331373700"
"002070","비비안","1730","1950","220","12.72","12003509","23690336750"
"100220","비상교육","6120","6500","380","6.21","1870409","12491013260"
"146320","비씨엔씨","17000","17050","50","0.29","1644784","28224496150"
"200780","비씨월드제약","10200","10900","700","6.86","1347384","15287725750"
"141000","비아트론","8320","9030","710","8.53","786120","6971786730"
"090460","비에이치","25500","28350","2850","11.18","16708136","455848244550"
"083650","비에이치아이","7600","8440","840","11.05","22806716","168470933660"
"215050","비엔디생활건강","912","912","0","0.00","0","0"
"142760","비엘","6110","6230","120","1.96","26491252","197071640650"
"065170","비엘팜텍","936","920","-16","-1.71","3916900","3708196033"
"086220","비엘헬스케어","2585","2750","165","6.38","852","2246560"
"086670","비엠티","12050","16350","4300","35.68","4158953","61251913100"
"335890","비올","2000","2070","70","3.50","4752839","9793414805"
"138580","비즈니스온","8060","8300","240","2.98","653561","5348207000"
"082920","비츠로셀","11150","13400","2250","20.18","1691051","20951757750"
"054220","비츠로시스","5640","2360","-3280","-58.16","41030060","120078409860"
"042370","비츠로테크","7050","7120","70","0.99","1503490","10580334180"
"030790","비케이탑스","904","904","0","0.00","0","0"
"050090","비케이홀딩스","520","571","51","9.81","20661981","11987426109"
"307870","비투엔","2050","2260","210","10.24","33415850","91895074935"
"357880","비트나인","12000","11300","-700","-5.83","4295999","49887436750"
"032850","비트컴퓨터","6620","7260","640","9.67","7008949","51782237900"
"148780","비플라이소프트","2140","2160","20","0.93","28910153","216103801940"
"238200","비피도","8380","8340","-40","-0.48","393924","3225618930"
"093190","빅솔론","6100","6900","800","13.11","1193309","8119037280"
"065450","빅텍","5340","6030","690","12.92","23731801","138809722045"
"210120","빅텐츠","18950","20400","1450","7.65","1577","29115900"
"005180","빙그레","46650","47100","450","0.96","159210","7524471700"
"072950","빛샘전자","6550","7190","640","9.77","583454","4073941520"
"266170","뿌리깊은나무들","1430","1080","-350","-24.48","141577","135893991"
"143240","사람인에이치알","33100","33500","400","1.21","730034","24035147650"
"003960","사조대림","24600","26200","1600","6.50","392447","9640543900"
"008040","사조동아원","1600","1360","-240","-15.00","59266760","85343536710"
"007160","사조산업","45200","45150","-50","-0.11","169950","7588418200"
"014710","사조씨푸드","5160","5790","630","12.21","20269264","120212797185"
"006090","사조오양","9120","9340","220","2.41","350084","3176966950"
"100090","삼강엠앤티","19450","27050","7600","39.07","15004276","348916668550"
"122350","삼기","3120","3505","385","12.34","4075988","13992397540"
"014970","삼륭물산","5960","6790","830","13.93","8625799","57301241020"
"018310","삼목에스폼","18700","21650","2950","15.78","1050566","20975616450"
"053700","삼보모터스","4000","4805","805","20.13","6222312","31483030700"
"009620","삼보산업","1105","1270","165","14.93","11645448","14183154095"
"023600","삼보판지","9540","10150","610","6.39","598056","5863357710"
"001470","삼부토건","2160","2170","10","0.46","102321079","214452949200"
"006400","삼성SDI","537000","615000","78000","14.53","5454063","3103767740765"
"006405","삼성SDI우","274000","309500","35500","12.96","45906","13457073500"
"006660","삼성공조","10600","10600","0","0.00","207248","2184941050"
"380320","삼성머스트스팩5호","4490","4975","485","10.80","30855466","150874722580"
"028260","삼성물산","114000","123500","9500","8.33","5394323","634231207000"
"02826K","삼성물산우B","103500","112000","8500","8.21","65438","7143919000"
"207940","삼성바이오로직스","819000","905000","86000","10.50","1257113","1070447742300"
"032830","삼성생명","60200","62300","2100","3.49","4046962","241117340470"
"377630","삼성스팩4호","6020","8410","2390","39.70","81851730","629178544120"
"425290","삼성스팩6호","7560","6530","-1030","-13.62","46618398","319945791730"
"018260","삼성에스디에스","132500","132000","-500","-0.38","2461922","326048951500"
"028050","삼성엔지니어링","20550","21750","1200","5.84","24875379","490293770650"
"009150","삼성전기","134500","134500","0","0.00","10986689","1525985101154"
"009155","삼성전기우","74800","76800","2000","2.67","104097","8114599600"
"005930","삼성전자","58700","59800","1100","1.87","299359481","18102348084526"
"005935","삼성전자우","53900","54700","800","1.48","18865932","1047215056061"
"001360","삼성제약","3330","3860","530","15.92","18360926","72837660540"
"010140","삼성중공업","5500","5980","480","8.73","74854422","418306743120"
"010145","삼성중공우","229500","231000","1500","0.65","8909","2017204000"
"016360","삼성증권","33650","35400","1750","5.20","5807869","193617687750"
"068290","삼성출판사","25550","27800","2250","8.81","1535713","41340070850"
"029780","삼성카드","30500","31700","1200","3.93","1546762","48096919968"
"000810","삼성화재","196500","202000","5500","2.80","1569197","312064625725"
"000815","삼성화재우","156000","158500","2500","1.60","114511","18002494500"
"006110","삼아알미늄","16900","23100","6200","36.69","5253652","112183091900"
"009300","삼아제약","14750","15400","650","4.41","230636","3527305450"
"145990","삼양사","41350","42600","1250","3.02","218795","9072564300"
"145995","삼양사우","32800","34900","2100","6.40","3647","124906100"
"003230","삼양식품","102500","111000","8500","8.29","1615589","172758782500"
"225190","삼양옵틱스","12650","12350","-300","-2.37","446834","5424988100"
"002170","삼양통상","53400","53300","-100","-0.19","27342","1445277500"
"272550","삼양패키징","17150","19750","2600","15.16","176596","3326683000"
"000070","삼양홀딩스","73500","74600","1100","1.50","300980","22047446400"
"000075","삼양홀딩스우","60000","59600","-400","-0.67","709","42352900"
"002810","삼영무역","13350","13650","300","2.25","102226","1382032050"
"361670","삼영에스앤씨","7000","7560","560","8.00","283102","2120745210"
"054540","삼영엠텍","5450","5890","440","8.07","43249744","233103781165"
"065570","삼영이엔씨","4890","7500","2610","53.37","17661414","109994385290"
"005680","삼영전자","10350","10450","100","0.97","564183","5862651700"
"003720","삼영화학","2475","3285","810","32.73","38494363","118998666245"
"023000","삼원강재","2580","2820","240","9.30","642857","1804924140"
"004380","삼익THK","12150","13850","1700","13.99","2342265","31872561050"
"002450","삼익악기","1410","1550","140","9.93","6509480","10315365650"
"032280","삼일","2155","2400","245","11.37","2577455","5887566230"
"002290","삼일기업공사","3720","4635","915","24.60","16726474","78292312560"
"004440","삼일씨엔에스","7540","9140","1600","21.22","1015872","9401388580"
"000520","삼일제약","7800","8100","300","3.85","2999420","24713472630"
"009770","삼정펄프","26250","29550","3300","12.57","1263259","36893097350"
"037460","삼지전자","9830","10200","370","3.76","508158","5175738330"
"032750","삼진","6750","7330","580","8.59","3479767","27804985380"
"054090","삼진엘앤디","3400","3450","50","1.47","70928554","243916871305"
"005500","삼진제약","24550","24450","-100","-0.41","2324842","58247879450"
"000250","삼천당제약","32650","36750","4100","12.56","3307269","116897015200"
"004690","삼천리","182000","194500","12500","6.87","603676","112079528000"
"024950","삼천리자전거","7680","7940","260","3.39","2231809","17257263080"
"038500","삼표시멘트","4050","4450","400","9.88","8656146","38275083965"
"017480","삼현철강","5500","5870","370","6.73","781600","4309914330"
"010960","삼호개발","3980","4300","320","8.04","975590","4021625990"
"046390","삼화네트웍스","3630","3860","230","6.34","18698168","69472187385"
"004450","삼화왕관","37050","42400","5350","14.44","995124","44101750850"
"009470","삼화전기","18250","19200","950","5.21","193055","3587853000"
"011230","삼화전자","2965","3050","85","2.87","407929","1240378555"
"001820","삼화콘덴서","39700","42550","2850","7.18","546461","23083671400"
"000390","삼화페인트","6690","8270","1580","23.62","4133956","33935254750"
"027580","상보","1495","1635","140","9.36","27502646","46239807035"
"038540","상상인","8740","9130","390","4.46","2935905","25851286390"
"101000","상상인인더스트리","747","798","51","6.83","17873554","15205755109"
"415580","상상인제3호스팩","2115","2105","-10","-0.47","376395","791770005"
"001290","상상인증권","960","1050","90","9.38","9718078","11085099437"
"041650","상신브레이크","3260","3400","140","4.29","416006","1404359110"
"091580","상신이디피","15900","18800","2900","18.24","8824756","157166679850"
"263810","상신전자","3370","3495","125","3.71","2013973","7060024440"
"089980","상아프론테크","29650","34400","4750","16.02","1230624","38895860050"
"042940","상지카일룸","1005","1030","25","2.49","17067058","17932459607"
"042600","새로닉스","20400","23750","3350","16.42","1388156","30778680900"
"075180","새론오토모티브","4830","4945","115","2.38","55071","269806940"
"252990","샘씨엔에스","5040","4995","-45","-0.89","5743320","29423603785"
"007540","샘표","57500","51700","-5800","-10.09","1094440","59435942850"
"248170","샘표식품","36000","38700","2700","7.50","1030288","41137829800"
"294630","서남","2730","2985","255","9.34","1472778","4216927185"
"038070","서린바이오","12650","16100","3450","27.27","31393425","536361838500"
"006730","서부T&D","7310","8570","1260","17.24","7798637","61903197900"
"079650","서산","2025","2195","170","8.40","1020646","2241388280"
"100660","서암기계공업","7680","6950","-730","-9.51","21737721","157750394220"
"007860","서연","7250","6950","-300","-4.14","2125344","15020088480"
"200880","서연이화","8130","8720","590","7.26","10242891","90659515650"
"019770","서연탑메탈","6330","5920","-410","-6.48","4430332","26262995910"
"017390","서울가스","243000","251000","8000","3.29","305133","73767604500"
"043710","서울리거","1025","955","-70","-6.83","2090420","2063334879"
"092190","서울바이오시스","7040","6950","-90","-1.28","5360043","39925089700"
"046890","서울반도체","10600","11200","600","5.66","3389948","36981870750"
"004410","서울식품","258","266","8","3.10","129813620","35378859432"
"004415","서울식품우","3230","3380","150","4.64","101825","347134425"
"063170","서울옥션","18800","23500","4700","25.00","7041170","145368044550"
"027040","서울전자통신","692","700","8","1.16","2000633","1329864349"
"018680","서울제약","4980","5310","330","6.63","3335680","20088739685"
"021050","서원","1410","1525","115","8.16","2512405","3601784120"
"093920","서원인텍","5650","5820","170","3.01","543523","3124312440"
"189860","서전기전","9440","9850","410","4.34","5599012","52459323700"
"178320","서진시스템","15150","15850","700","4.62","3501200","54174986950"
"122690","서진오토모티브","3085","3165","80","2.59","998536","3096600660"
"140070","서플러스글로벌","3400","3730","330","9.71","1773202","6391534335"
"011370","서한","1345","1485","140","10.41","12828837","18095245415"
"065710","서호전기","17850","18850","1000","5.60","89522","1656089900"
"008490","서흥","32200","36200","4000","12.42","245909","8457150400"
"035890","서희건설","1420","1520","100","7.04","11929933","17005706560"
"357550","석경에이티","17300","19150","1850","10.69","1844959","33905907850"
"003100","선광","90400","99200","8800","9.73","1035123","97820405900"
"007610","선도전기","3000","3000","0","0.00","0","0"
"067370","선바이오","17350","18300","950","5.48","102491","1778274850"
"171090","선익시스템","16400","17900","1500","9.15","3506707","61797729750"
"136490","선진","10150","11250","1100","10.84","1694722","17666584390"
"086710","선진뷰티사이언스","5940","6540","600","10.10","1583596","9979070740"
"014620","성광벤드","11050","14500","3450","31.22","14022188","170437315150"
"037350","성도이엔지","5200","5540","340","6.54","2469005","13008608495"
"014910","성문전자","1800","2045","245","13.61","4020110","8002636400"
"014915","성문전자우","8240","8750","510","6.19","12890","109333800"
"003080","성보화학","3590","3760","170","4.74","2415206","8721088625"
"004980","성신양회","9450","10600","1150","12.17","4961756","50578463240"
"004985","성신양회우","13350","15150","1800","13.48","1006381","16242555650"
"011300","성안","593","1095","502","84.65","159454145","157672556358"
"081580","성우전자","2905","3040","135","4.65","678640","1997204935"
"045300","성우테크론","4660","5040","380","8.15","4881221","24442396225"
"015750","성우하이텍","4370","5380","1010","23.11","41561198","225669022355"
"000180","성창기업지주","2000","2200","200","10.00","6560098","14007736755"
"080470","성창오토텍","6810","7510","700","10.28","603196","4452936840"
"043260","성호전자","1505","1495","-10","-0.66","8250371","12623725190"
"148150","세경하이테크","17000","19750","2750","16.18","1556594","30192584350"
"002420","세기상사","8360","9600","1240","14.83","674847","6473612690"
"053060","세동","1395","1585","190","13.62","11626689","17786213405"
"340440","세림B&G","4040","3825","-215","-5.32","182904350","717607503340"
"017510","세명전기","3920","3925","5","0.13","904073","3447384505"
"004360","세방","10350","12900","2550","24.64","982649","11336265370"
"004365","세방우","6830","7070","240","3.51","21259","147928330"
"004490","세방전지","50900","55100","4200","8.25","873216","46027276950"
"011560","세보엠이씨","8230","8600","370","4.50","1498391","12211521790"
"396300","세아메카닉스","6860","7760","900","13.12","65772421","496978088010"
"001430","세아베스틸지주","15100","15600","500","3.31","885762","13183486600"
"306200","세아제강","151000","175000","24000","15.89","530406","84829305500"
"003030","세아제강지주","128000","160500","32500","25.39","500368","73525873500"
"019440","세아특수강","14050","14200","150","1.07","174228","2399652650"
"058650","세아홀딩스","95800","102500","6700","6.99","3911","382345900"
"013000","세우글로벌","1640","1690","50","3.05","2603642","4271501210"
"100700","세운메디칼","3280","3515","235","7.16","10658913","38167807245"
"024830","세원물산","6280","6280","0","0.00","0","0"
"091090","세원이앤씨","636","845","209","32.86","77982437","64401912031"
"021820","세원정공","8090","8090","0","0.00","0","0"
"067830","세이브존I&C","2895","2900","5","0.17","700249","2045237195"
"033530","세종공업","5390","6170","780","14.47","7048687","42088237980"
"258830","세종메디칼","4140","5560","1420","34.30","215741974","1418600390225"
"036630","세종텔레콤","778","789","11","1.41","8003367","6439130534"
"039310","세중","2850","2915","65","2.28","1478021","4281063300"
"075580","세진중공업","5810","7490","1680","28.92","9348722","62538955980"
"067770","세진티에스","3615","3740","125","3.46","269590","1006641700"
"053450","세코닉스","7770","8170","400","5.15","1196309","9388939990"
"027970","세하","1315","1370","55","4.18","1793655","2431019935"
"252500","세화피앤씨","1350","1400","50","3.70","2989620","4054806715"
"347000","센코","12650","14600","1950","15.42","233855","3172021200"
"308170","센트랄모텍","12900","18650","5750","44.57","17042506","294685006450"
"012600","센트럴인사이트","2490","2490","0","0.00","0","0"
"331920","셀레믹스","7120","8590","1470","20.65","3910233","38252134030"
"049180","셀루메드","4415","6140","1725","39.07","48587653","288072557810"
"299660","셀리드","20450","23600","3150","15.40","12128087","312271692150"
"268600","셀리버리","16050","16900","850","5.30","10899724","299176513950"
"108860","셀바스AI","6910","7360","450","6.51","4575489","32887866590"
"208370","셀바스헬스케어","2305","2310","5","0.22","985848","2301199595"
"258250","셀젠텍","7050","6960","-90","-1.28","26810","185043740"
"068270","셀트리온","182500","212500","30000","16.44","9570500","1850221132000"
"068760","셀트리온제약","79400","90000","10600","13.35","2642556","219745895300"
"091990","셀트리온헬스케어","71500","79400","7900","11.05","14373004","1046129077300"
"060230","소니드","3640","4125","485","13.32","12939848","50218894610"
"290690","소룩스","8810","8580","-230","-2.61","396405","3431872370"
"053110","소리바다","3960","3960","0","0.00","0","0"
"950200","소마젠","5590","6180","590","10.55","2764952","17774048080"
"032680","소프트센","1770","1870","100","5.65","29664341","58043100270"
"032685","소프트센우","26350","24350","-2000","-7.59","26574","644119300"
"258790","소프트캠프","1725","1770","45","2.61","5038310","9530134895"
"066910","손오공","2305","2215","-90","-3.90","1765774","3991063505"
"043100","솔고바이오","574","591","17","2.96","5600226","3288040632"
"336370","솔루스첨단소재","42850","46800","3950","9.22","6832526","289775594850"
"33637K","솔루스첨단소재1우","10600","11450","850","8.02","607974","6285390080"
"33637L","솔루스첨단소재2우B","13800","14400","600","4.35","425203","6243486850"
"154040","솔루에타","2825","2885","60","2.12","327230","926237390"
"248070","솔루엠","19400","21500","2100","10.82","2069052","42242694600"
"035610","솔본","3695","4190","495","13.40","6041852","26397080385"
"357780","솔브레인","229600","225700","-3900","-1.70","462027","103983256300"
"036830","솔브레인홀딩스","19550","22100","2550","13.04","448877","9109712700"
"304100","솔트룩스","9320","10050","730","7.83","652973","6511891800"
"004430","송원산업","19800","19000","-800","-4.04","8387869","160122248100"
"086980","쇼박스","4860","5090","230","4.73","53805322","292946876405"
"050960","수산아이앤티","11150","12100","950","8.52","629422","7234758200"
"017550","수산중공업","3185","3120","-65","-2.04","16538758","49699943090"
"253840","수젠텍","15850","13900","-1950","-12.30","28040743","477576169400"
"185190","수프로","1520","1395","-125","-8.22","32133","82346820"
"236200","슈프리마","21700","24050","2350","10.83","593762","13961639900"
"317770","슈프리마아이디","14550","16200","1650","11.34","2082942","34546038400"
"094840","슈프리마에이치큐","6010","6610","600","9.98","416180","2620788010"
"192440","슈피겐코리아","38050","37550","-500","-1.31","94979","3572371950"
"136510","스마트솔루션즈","11600","11600","0","0.00","0","0"
"099440","스맥","2595","2680","85","3.28","27924901","71356464900"
"053210","스카이라이프","9070","10000","930","10.25","10084695","95057391550"
"033790","스카이문스테크놀로지","829","829","0","0.00","0","0"
"131100","스카이이앤엠","2935","3230","295","10.05","452578","1393013985"
"276040","스코넥","12150","13050","900","7.41","4709931","61718448850"
"159910","스킨앤스킨","236","231","-5","-2.12","134944883","33843664549"
"115570","스타플렉스","4375","4370","-5","-0.11","631421","2725108195"
"258540","스템랩","2990","2460","-530","-17.73","91168","213929070"
"330730","스톤브릿지벤처스","5850","6120","270","4.62","9089986","58868504370"
"253450","스튜디오드래곤","73600","82000","8400","11.41","3079028","236117623800"
"204630","스튜디오산타클로스","7140","9090","1950","27.31","9971101","105063022300"
"026890","스틱인베스트먼트","7310","8240","930","12.72","13626807","111028996220"
"013810","스페코","5830","6470","640","10.98","11260071","69077055180"
"049830","승일","14850","14950","100","0.67","15056156","235346574500"
"020710","시공테크","5300","5590","290","5.47","3531146","19303793905"
"033170","시그네틱스","1635","1705","70","4.28","22556603","39155141985"
"048870","시너지이노베이션","3680","4205","525","14.27","6986995","27947789820"
"025320","시노펙스","3305","3400","95","2.87","118239802","406527600245"
"134790","시디즈","51100","48450","-2650","-5.19","1351305","72378537400"
"269620","시스웍","889","889","0","0.00","0","0"
"131090","시큐브","1055","1110","55","5.21","1444501","1549421585"
"232830","시큐센","2815","4270","1455","51.69","60173","209337665"
"139050","시티랩스","614","607","-7","-1.14","5377775","3249309586"
"016590","신대양제지","87000","86300","-700","-0.80","28813","2512783700"
"290520","신도기연","4885","5290","405","8.29","1812672","10037833245"
"029530","신도리코","31350","32100","750","2.39","231164","7317582186"
"004970","신라교역","10400","10750","350","3.37","128158","1361941800"
"001000","신라섬유","1765","2135","370","20.96","48832162","105827627690"
"025870","신라에스지","10500","11250","750","7.14","1273314","14687237200"
"215600","신라젠","12100","12100","0","0.00","0","0"
"065350","신성델타테크","10300","12050","1750","16.99","2718423","30307937460"
"011930","신성이엔지","1915","2375","460","24.02","143335691","316871737015"
"005390","신성통상","2945","3140","195","6.62","15811646","48487651275"
"004170","신세계","217500","226000","8500","3.91","1039729","226615507500"
"035510","신세계 I&C","13850","15150","1300","9.39","697977","9970553350"
"034300","신세계건설","25400","26750","1350","5.31","134919","3420158100"
"031430","신세계인터내셔날","29850","30050","200","0.67","2690409","80026019550"
"031440","신세계푸드","57800","61900","4100","7.09","123683","7389551700"
"006880","신송홀딩스","13050","10000","-3050","-23.37","11184755","124416843830"
"002800","신신제약","5250","5490","240","4.57","1320704","7351408920"
"344050","신영스팩6호","2285","2285","0","0.00","0","0"
"419270","신영스팩7호","2145","2135","-10","-0.47","316418","679073225"
"005800","신영와코루","11600","11900","300","2.59","172984","1998099600"
"001720","신영증권","55100","57000","1900","3.45","51731","2888193200"
"001725","신영증권우","57000","58200","1200","2.11","16015","916609400"
"009270","신원","1655","1795","140","8.46","15157447","25697024530"
"017000","신원종합개발","7230","7950","720","9.96","7826682","59746073600"
"002700","신일전자","2210","1910","-300","-13.57","46433350","96788830250"
"012790","신일제약","8900","9680","780","8.76","5682946","59847891210"
"138070","신진에스엠","5154","4115","-1039","-20.16","46160838","459631846650"
"226330","신테카바이오","9600","10950","1350","14.06","1517156","16081673880"
"019170","신풍제약","24600","28650","4050","16.46","34830217","1081278258900"
"019175","신풍제약우","46000","46150","150","0.33","278600","13822217550"
"002870","신풍제지","1580","1740","160","10.13","29174013","56834894780"
"404990","신한서부티엔디리츠","5020","4785","-235","-4.68","1656879","8011856840"
"293940","신한알파리츠","7790","7800","10","0.13","2154941","16740974600"
"333050","신한제6호스팩","2350","2165","-185","-7.87","24626846","65153490825"
"366330","신한제7호스팩","2135","2115","-20","-0.94","3475907","7801111905"
"393360","신한제8호스팩","2150","2150","0","0.00","248507","533953655"
"405640","신한제9호스팩","2145","2125","-20","-0.93","426955","910796690"
"055550","신한지주","36250","35950","-300","-0.83","29145999","1029208352085"
"056700","신화인터텍","4200","5100","900","21.43","193505821","1000757963030"
"187270","신화콘텍","5970","5840","-130","-2.18","10430363","63035526640"
"004080","신흥","16300","16000","-300","-1.84","35447","568911650"
"243840","신흥에스이씨","52600","58100","5500","10.46","948670","51973525200"
"257720","실리콘투","4425","2675","-1750","-39.55","44031112","218299343615"
"222800","심텍","38000","37750","-250","-0.66","18491940","741863436450"
"036710","심텍홀딩스","3840","4215","375","9.77","21986302","100057842535"
"160980","싸이맥스","13850","14500","650","4.69","546920","7997285400"
"356890","싸이버원","10800","11350","550","5.09","11783081","156424479250"
"217330","싸이토젠","58400","60100","1700","2.91","144254","8507641300"
"102280","쌍방울","545","543","-2","-0.37","101772526","55905726424"
"003410","쌍용C&E","6520","6890","370","5.67","10241020","66890523770"
"010280","쌍용정보통신","1160","1070","-90","-7.76","8371939","9102426700"
"003620","쌍용차","2770","2770","0","0.00","0","0"
"004770","써니전자","2725","2855","130","4.77","27439836","78015810020"
"217320","썬테크","6710","5310","-1400","-20.86","347","2404940"
"208640","썸에이지","1135","1180","45","3.96","21330109","26089195935"
"222420","쎄노텍","2035","2145","110","5.41","12476133","26623467860"
"037760","쎄니트","1660","1900","240","14.46","19600799","37766115310"
"099320","쎄트렉아이","32950","36200","3250","9.86","1279040","44375220800"
"015540","쎌마테라퓨틱스","6410","6410","0","0.00","0","0"
"049960","쎌바이오텍","13850","13700","-150","-1.08","214431","2965395750"
"050890","쏠리드","5040","5510","470","9.33","3860762","20448362805"
"066790","씨씨에스","549","519","-30","-5.46","3975988","2110350594"
"222080","씨아이에스","13650","15700","2050","15.02","23017024","336357302450"
"004920","씨아이테크","1270","1250","-20","-1.57","26154413","35183530320"
"236030","씨알푸드","6590","6930","340","5.16","74","480850"
"103660","씨앗","5950","5950","0","0.00","0","0"
"352480","씨앤씨인터내셔널","17400","19850","2450","14.08","592549","11813266350"
"245450","씨앤에스링크","2080","2060","-20","-0.96","14","29125"
"264660","씨앤지하이테크","11500","11800","300","2.61","480114","5860187550"
"352700","씨앤투스성진","5290","5670","380","7.18","9683679","55854615550"
"297090","씨에스베어링","9760","12700","2940","30.12","68857507","733790128460"
"112610","씨에스윈드","49150","65300","16150","32.86","7398536","406510696500"
"359090","씨엔알리서치","1780","1710","-70","-3.93","1666715","2881432190"
"286000","씨엔티드림","3210","2595","-615","-19.16","65327","168407950"
"115530","씨엔플러스","536","679","143","26.68","16100133","9955986190"
"115480","씨유메디칼","1075","1150","75","6.98","9720672","10714482168"
"376290","씨유테크","4660","5270","610","13.09","5821341","33160343730"
"189330","씨이랩","13150","13750","600","4.56","303723","4015032150"
"096530","씨젠","44700","39800","-4900","-10.96","19998286","885904991000"
"900120","씨케이에이치","252","269","17","6.75","40372994","10667148695"
"101240","씨큐브","6670","7110","440","6.60","324697","2194720510"
"060590","씨티씨바이오","8200","8830","630","7.68","1452035","12199210100"
"260930","씨티케이","7050","7850","800","11.35","729703","5418251350"
"013990","아가방컴퍼니","2960","3150","190","6.42","1705684","5194279705"
"123860","아나패스","22050","23750","1700","7.71","345929","8114126900"
"025980","아난티","6740","7660","920","13.65","9271147","64594904280"
"008700","아남전자","2350","2780","430","18.30","118289664","318416147570"
"058220","아리온","275","275","0","0.00","0","0"
"125210","아모그린텍","11100","13850","2750","24.77","6606302","81185205600"
"002790","아모레G","37800","35850","-1950","-5.16","2514332","93320265250"
"00279K","아모레G3우(전환)","31950","29600","-2350","-7.36","56210","1745756500"
"002795","아모레G우","14450","14200","-250","-1.73","156778","2247963400"
"090430","아모레퍼시픽","133000","127000","-6000","-4.51","5094830","666577844500"
"090435","아모레퍼시픽우","49800","48050","-1750","-3.51","396549","19186163447"
"357580","아모센스","12650","16200","3550","28.06","5517566","82960215750"
"052710","아모텍","21750","26400","4650","21.38","872863","21243921550"
"074430","아미노로직스","2740","2615","-125","-4.56","34291685","87019297530"
"092040","아미코젠","24300","26350","2050","8.44","1771814","43249817100"
"083930","아바코","10400","11750","1350","12.98","1285014","14095596800"
"149950","아바텍","15000","15950","950","6.33","465427","7747195350"
"036010","아비코전자","10050","12050","2000","19.90","4817320","52889305480"
"002030","아세아","114000","125000","11000","9.65","45671","5396424500"
"183190","아세아시멘트","11150","12950","1800","16.14","2977685","34580943570"
"002310","아세아제지","33700","37200","3500","10.39","392334","13859754050"
"050860","아세아텍","2850","3065","215","7.54","3389271","9967740345"
"012170","아센디오","1330","1140","-190","-14.29","5755340","6938683820"
"136410","아셈스","14000","15250","1250","8.93","5764670","87660948350"
"246720","아스타","4085","4265","180","4.41","348593","1457853615"
"067390","아스트","5090","5240","150","2.95","2035224","11324870435"
"159010","아스플로","7703","11800","4097","53.19","17725305","263350837750"
"127710","아시아경제","2075","2185","110","5.30","2680629","5983520815"
"267850","아시아나IDT","14300","14050","-250","-1.75","265344","3717579850"
"020560","아시아나항공","15250","15200","-50","-0.33","6363530","93857926200"
"154030","아시아종묘","4390","4435","45","1.03","3024433","14274882480"
"227610","아우딘퓨쳐스","1505","1760","255","16.94","5237330","8491301815"
"143160","아이디스","23450","26300","2850","12.15","243579","5985768400"
"054800","아이디스홀딩스","12700","13300","600","4.72","170284","2244987000"
"332370","아이디피","7730","8830","1100","14.23","666095","5588143420"
"122900","아이마켓코리아","10250","10350","100","0.98","751536","7662325310"
"339950","아이비김영","2135","2450","315","14.75","40059918","107663715615"
"099190","아이센스","32750","37800","5050","15.42","1971359","69061182050"
"289010","아이스크림에듀","4445","5180","735","16.54","21554807","120892599175"
"214430","아이쓰리시스템","17050","19150","2100","12.32","497434","9221226550"
"040910","아이씨디","9200","9620","420","4.57","322719","3001140620"
"068940","아이씨케이","3865","4170","305","7.89","18735339","73452389885"
"052860","아이앤씨","2950","2975","25","0.85","604441","1771531100"
"010780","아이에스동서","40800","41700","900","2.21","1330783","53336576600"
"069920","아이에스이커머스","8160","7960","-200","-2.45","8932940","73859221970"
"038880","아이에이","803","818","15","1.87","24150404","19592258974"
"307180","아이엘사이언스","4035","4025","-10","-0.25","2534394","9750007445"
"101390","아이엠","4780","5300","520","10.88","876764","4525226195"
"078860","아이오케이","721","742","21","2.91","17204747","13260212841"
"114810","아이원스","7310","8010","700","9.58","1676153","12973284310"
"090150","아이윈","1810","2330","520","28.73","40999352","91683867590"
"123010","아이윈플러스","720","692","-28","-3.89","46295895","29838840561"
"031310","아이즈비전","2900","3035","135","4.66","1480362","4469985640"
"185490","아이진","9650","10750","1100","11.40","7199801","76738812040"
"059100","아이컴포넌트","6510","6680","170","2.61","359658","2396705850"
"149010","아이케이세미콘","7970","7400","-570","-7.15","21310","160384420"
"262840","아이퀘스트","8880","9390","510","5.74","10779714","102337204210"
"175250","아이큐어","13300","12950","-350","-2.63","3756780","52456551650"
"052460","아이크래프트","3550","3740","190","5.35","5066546","20101769150"
"119830","아이텍","9380","8400","-980","-10.45","6977842","64227975430"
"052770","아이톡시","2085","2085","0","0.00","0","0"
"124500","아이티센","4155","4310","155","3.73","1436086","5950424285"
"372800","아이티아이즈","12600","12400","-200","-1.59","7554690","89171267020"
"084850","아이티엠반도체","32050","35150","3100","9.67","420936","13956090350"
"114840","아이패밀리에스씨","12200","12850","650","5.33","1576535","19413481350"
"027360","아주IB투자","2965","3195","230","7.76","63640331","214153423815"
"139990","아주스틸","10400","11650","1250","12.02","1611954","18451353100"
"032080","아즈텍WB","2200","2545","345","15.68","28146572","73570239350"
"013310","아진산업","2705","3010","305","11.28","10030420","29189634405"
"059120","아진엑스텍","9550","11100","1550","16.23","4475021","47863855070"
"158430","아톤","28750","29800","1050","3.65","842191","24911190800"
"149300","아퓨어스","1680","1680","0","0.00","17398","28304145"
"067160","아프리카TV","83400","85000","1600","1.92","4647831","399806426400"
"001540","안국약품","8370","9320","950","11.35","4799524","47867297270"
"053800","안랩","88900","92500","3600","4.05","3356657","303168660000"
"251280","안지오랩","9970","8890","-1080","-10.83","27290","245441170"
"065660","안트로젠","21400","22400","1000","4.67","1107386","24432640550"
"297570","알로이스","1635","2110","475","29.05","102306455","222186616110"
"001780","알루코","2950","3205","255","8.64","12630426","38786202690"
"260660","알리코제약","6240","6810","570","9.13","2049697","14019397240"
"361570","알비더블유","17950","18200","250","1.39","10320579","204360331550"
"131370","알서포트","4720","5180","460","9.75","23499155","127697822050"
"140670","알에스오토메이션","13350","15650","2300","17.23","8165660","128796702700"
"096610","알에프세미","3080","4175","1095","35.55","17165838","71532784685"
"061040","알에프텍","5280","5690","410","7.77","3739023","20465814000"
"148250","알엔투테크놀로지","8330","8110","-220","-2.64","1789667","15096649890"
"347860","알체라","13700","16050","2350","17.15","1469569","22045065150"
"196170","알테오젠","63900","74300","10400","16.28","8622357","588358175800"
"123750","알톤스포츠","3205","3615","410","12.79","8610568","31135606230"
"085810","알티캐스트","1600","1745","145","9.06","3864102","6600575205"
"117670","알파홀딩스","2490","2325","-165","-6.63","4895641","11790063630"
"291650","압타머사이언스","13200","10700","-2500","-18.94","11846640","150176372100"
"293780","압타바이오","17050","19050","2000","11.73","31700631","712383076800"
"267810","앙츠","1335","1490","155","11.61","3780","5509095"
"018250","애경산업","14450","14150","-300","-2.08","411194","5962084800"
"161000","애경케미칼","8260","8580","320","3.87","1618466","13205472900"
"196300","애니젠","9470","9440","-30","-0.32","214158","1980729710"
"310200","애니플러스","2860","3200","340","11.89","7884088","25138534640"
"179530","애드바이오텍","4780","5110","330","6.90","2001589","9794300680"
"900100","애머릿지","3585","3585","0","0.00","0","0"
"205500","액션스퀘어","2700","3340","640","23.70","14663110","47575012645"
"052790","액토즈소프트","9040","9910","870","9.62","523178","4950173550"
"290740","액트로","7230","7370","140","1.94","992368","7184795000"
"238090","앤디포스","6800","7290","490","7.21","5332018","40009868550"
"092600","앤씨앤","2905","2415","-490","-16.87","4981444","12539453745"
"129890","앱코","11450","11450","0","0.00","1025251","11653691350"
"174900","앱클론","11450","12700","1250","10.92","3199064","41081694050"
"255440","야스","9170","9350","180","1.96","239222","2285477500"
"030960","양지사","7420","16250","8830","119.00","20414820","275645844340"
"102120","어보브반도체","9950","10750","800","8.04","1765195","18216963160"
"263540","어스앤에어로스페이스","10900","10900","0","0.00","0","0"
"238120","얼라인드","9860","10150","290","2.94","555636","5547923910"
"224810","엄지하우스","6470","4775","-1695","-26.20","4618","20594555"
"019990","에너토크","10700","12100","1400","13.08","3502510","38245269930"
"011090","에넥스","1370","1605","235","17.15","16728008","25617915455"
"270660","에브리봇","29500","35650","6150","20.85","7884910","289509087550"
"038680","에스넷","5560","6140","580","10.43","5026662","32390162000"
"137310","에스디바이오센서","43900","39150","-4750","-10.82","15572199","700424465500"
"217480","에스디생명공학","1960","2900","940","47.96","14383761","39414345675"
"121890","에스디시스템","739","739","0","0.00","0","0"
"097780","에스맥","3385","3385","0","0.00","0","0"
"042110","에스씨디","2250","1870","-380","-16.89","19600644","40296413285"
"298060","에스씨엠생명과학","10950","11250","300","2.74","1119152","12865766700"
"065420","에스아이리소스","699","783","84","12.02","52822477","41523906324"
"270210","에스알바이오텍","4205","3870","-335","-7.97","2734","10414390"
"103230","에스앤더블류","2505","2505","0","0.00","0","0"
"260970","에스앤디","19050","20000","950","4.99","281557","5369277050"
"101490","에스앤에스텍","19650","20000","350","1.78","1973065","39698973950"
"095910","에스에너지","4335","5430","1095","25.26","55118865","269947807025"
"275630","에스에스알","4780","5550","770","16.11","392642","2060599845"
"031330","에스에이엠티","3540","3680","140","3.95","2770177","10067946175"
"060540","에스에이티","2715","2690","-25","-0.92","3011944","8103361425"
"351320","에스에이티이엔지","3570","3620","50","1.40","2098830","7652851220"
"056190","에스에프에이","39850","42150","2300","5.77","2567847","106693216100"
"080000","에스엔유","2895","3010","115","3.97","1016736","3043643375"
"086460","에스엔피제네틱스","10000","7900","-2100","-21.00","13753","106122180"
"005850","에스엘","28900","30950","2050","7.09","4065975","127122104100"
"214310","에스엘바이오닉스","3490","5890","2400","68.77","3673330","17623292780"
"246250","에스엘에스바이오","7100","7000","-100","-1.41","62066","453408300"
"041510","에스엠","68500","74500","6000","8.76","8095800","573416245600"
"010580","에스엠벡셀","1530","1530","0","0.00","0","0"
"299670","에스엠비나","3000","2785","-215","-7.17","155","441675"
"007820","에스엠코어","6140","7050","910","14.82","5805268","39261330280"
"109610","에스와이","3775","3685","-90","-2.38","32423122","118164234570"
"012750","에스원","63700","62400","-1300","-2.04","929519","58646498350"
"306040","에스제이그룹","21050","22050","1000","4.75","456792","9739418450"
"217910","에스제이켐","310","304","-6","-1.94","42669","12956073"
"224020","에스케이씨에스","3740","4340","600","16.04","13938","54222170"
"408920","에스케이증권7호스팩","2185","2185","0","0.00","0","0"
"096630","에스코넥","1170","1235","65","5.56","1786757","2111637430"
"069510","에스텍","6650","7510","860","12.93","376610","2748993900"
"041910","에스텍파마","7720","8850","1130","14.64","3349639","29938894180"
"234300","에스트래픽","3880","4125","245","6.31","2257965","9708579570"
"039440","에스티아이","15750","15250","-500","-3.17","3323155","53703198550"
"098660","에스티오","2370","2285","-85","-3.59","908438","2035699445"
"052020","에스티큐브","7160","19150","11990","167.46","34451107","466219970070"
"237690","에스티팜","95100","117000","21900","23.03","2882986","294971345000"
"050760","에스폴리텍","3395","3640","245","7.22","6427511","23878678475"
"288620","에스퓨얼셀","22100","24450","2350","10.63","1606328","36450593850"
"317830","에스피시스템스","10100","10500","400","3.96","8932981","91742214142"
"058610","에스피지","12850","17200","4350","33.85","18297768","275220415150"
"043340","에쎈테크","1240","1010","-230","-18.55","8696424","9563349690"
"023960","에쓰씨엔지니어링","2365","2275","-90","-3.81","6227992","14153325990"
"298690","에어부산","3859","3580","-279","-7.23","4807786","7936968750"
"187660","에이디엠코리아","3150","3115","-35","-1.11","3833985","12317485795"
"054630","에이디칩스","291","351","60","20.62","98821126","38699969943"
"200710","에이디테크놀로지","13300","14100","800","6.02","852035","11738739750"
"096690","에이루트","428","521","93","21.73","177361288","96219156643"
"140910","에이리츠","5570","5650","80","1.44","110175","595900560"
"078520","에이블씨엔씨","5260","5220","-40","-0.76","909727","4799970700"
"298380","에이비엘바이오","25500","25550","50","0.20","12248273","294056565500"
"203400","에이비온","8150","10550","2400","29.45","2841313","27931302470"
"195990","에이비프로바이오","854","840","-14","-1.64","34663200","30198397061"
"003800","에이스침대","40950","43000","2050","5.01","11964","503770150"
"088800","에이스테크","7240","7920","680","9.39","4118660","31163478140"
"241840","에이스토리","27750","26650","-1100","-3.96","17704651","548420004550"
"312610","에이에프더블류","3345","3760","415","12.41","4071253","15873024780"
"015260","에이엔피","2445","2325","-120","-4.91","4435843","10191153205"
"234070","에이원알폼","24850","24850","0","0.00","0","0"
"072990","에이치시티","11000","10650","-350","-3.18","508644","5600577450"
"227100","에이치앤비디자인","7090","4775","-2315","-32.65","4566658","26226423055"
"044990","에이치엔에스하이텍","12150","12150","0","0.00","0","0"
"239610","에이치엘사이언스","35450","30800","-4650","-13.12","61912","1989595400"
"353070","에이치엠씨제4호스팩","2115","2105","-10","-0.47","175485","371467015"
"353060","에이치엠씨제5호스팩","2120","2100","-20","-0.94","187274","393929330"
"044780","에이치케이","1830","1905","75","4.10","1746394","3156406480"
"357230","에이치피오","9610","11900","2290","23.83","4355054","53020386990"
"071670","에이테크솔루션","12600","13250","650","5.16","1405652","17792438250"
"045660","에이텍","12550","12950","400","3.19","4764452","60564067600"
"224110","에이텍티앤","13200","12200","-1000","-7.58","1759438","22888361500"
"230980","에이트원","849","1010","161","18.96","32564360","34160499302"
"021080","에이티넘인베스트","3190","3480","290","9.09","18071155","63233000790"
"089530","에이티세미콘","1130","1090","-40","-3.54","18098045","20167811722"
"200470","에이팩트","4000","5040","1040","26.00","23818715","132969475430"
"207490","에이펙스인텍","7450","8010","560","7.52","2490","19985140"
"262260","에이프로","11150","13400","2250","20.18","3108549","41226911550"
"007460","에이프로젠","1595","1500","-95","-5.96","60984247","94326078185"
"109960","에이프로젠 H&G","518","535","17","3.28","2972364","1582957144"
"003060","에이프로젠제약","595","672","77","12.94","18510036","12113440058"
"244920","에이플러스에셋","6030","6330","300","4.98","1877680","11750439090"
"089970","에이피티씨","16050","17200","1150","7.17","3313311","54433072200"
"230240","에치에프알","27650","33550","5900","21.34","1906747","58485889250"
"230360","에코마케팅","14800","18100","3300","22.30","5498925","94893644350"
"038870","에코바이오","6720","6860","140","2.08","943228","6327906700"
"128540","에코캡","6230","7990","1760","28.25","56979113","435585390080"
"086520","에코프로","71400","119600","48200","67.51","26593372","2558729942900"
"247540","에코프로비엠","118900","122700","3800","3.20","26361448","3141542701600"
"383310","에코프로에이치엔","37750","61200","23450","62.12","7639065","410003111900"
"038110","에코플라스틱","2735","3000","265","9.69","49367819","147312008040"
"073540","에프알텍","3070","3120","50","1.63","718742","2205139075"
"064850","에프앤가이드","6410","7960","1550","24.18","5222316","40619481160"
"064090","에프앤리퍼블릭","2585","2790","205","7.93","393637","1050913970"
"036810","에프에스티","14650","15250","600","4.10","949612","14157937950"
"173940","에프엔씨엔터","5900","5630","-270","-4.58","388440","2261554850"
"083500","에프엔에스테크","8010","9320","1310","16.35","738116","6352540350"
"054940","엑사이엔씨","1140","1195","55","4.82","2545647","2903992645"
"950130","엑세스바이오","17200","17550","350","2.03","50416298","999007180200"
"205100","엑셈","3785","4180","395","10.44","6561241","26548966475"
"070300","엑스큐어","2555","3115","560","21.92","389002","1151127135"
"092870","엑시콘","9280","9800","520","5.60","847031","8260972990"
"317870","엔바이오니아","11200","8550","-2650","-23.66","786917","7280016950"
"067570","엔브이에이치코리아","3465","3765","300","8.66","1448819","5221991495"
"236810","엔비티","7390","7160","-230","-3.11","3456613","26158677560"
"140610","엔솔바이오사이언스","14000","13000","-1000","-7.14","140854","1882819850"
"333620","엔시스","13500","14950","1450","10.74","472908","6660329950"
"101400","엔시트론","781","793","12","1.54","6030901","4756412180"
"036570","엔씨소프트","373500","401500","28000","7.50","2168598","821163338250"
"217820","엔에스","8360","8800","440","5.26","1614185","14591305220"
"031860","엔에스엔","1200","1280","80","6.67","21937338","26602985170"
"238170","엔에스엠","766","849","83","10.84","39266","27347927"
"224760","엔에스컴퍼니","3295","2450","-845","-25.64","6092","15962555"
"380440","엔에이치스팩19호","2100","2090","-10","-0.48","1530003","3203404670"
"391060","엔에이치스팩20호","2100","2085","-15","-0.71","643328","1346776085"
"396770","엔에이치스팩22호","2150","2130","-20","-0.93","237004","509784710"
"422040","엔에이치스팩23호","2115","2115","0","0.00","465052","987889920"
"265740","엔에프씨","11250","10850","-400","-3.56","443789","4947536700"
"354200","엔젠바이오","8180","8780","600","7.33","2156273","22141127730"
"093510","엔지브이아이","2000","2000","0","0.00","100","198875"
"208860","엔지스테크널러지","2205","2205","0","0.00","0","0"
"183490","엔지켐생명과학","17000","21050","4050","23.82","11575034","267003775750"
"085310","엔케이","873","999","126","14.43","1898310","1731683710"
"182400","엔케이맥스","15300","16850","1550","10.13","10587756","174699248700"
"348370","엔켐","47100","57200","10100","21.44","2709283","136977493550"
"069410","엔텔스","5640","6100","460","8.16","890536","5377677950"
"227950","엔투텍","1385","1330","-55","-3.97","8268852","11593277520"
"291230","엔피","7210","7750","540","7.49","13395996","107303799090"
"198080","엔피디","2380","2545","165","6.93","372545","923012550"
"048830","엔피케이","2020","2245","225","11.14","3287427","7106144040"
"096870","엘디티","3685","3695","10","0.27","399386","1475196695"
"276240","엘리비젼","598","749","151","25.25","16375","9387793"
"900140","엘브이엠씨홀딩스","2920","3070","150","5.14","3110796","9141315920"
"376190","엘비루셈","7310","7800","490","6.70","361569","2766206380"
"061970","엘비세미콘","8310","9360","1050","12.64","7976082","72374345810"
"138690","엘아이에스","982","982","0","0.00","0","0"
"290650","엘앤씨바이오","31700","28500","-3200","-10.09","2857575","86522404950"
"066970","엘앤에프","214200","244400","30200","14.10","9943588","2251594170700"
"156100","엘앤케이바이오","10350","11500","1150","11.11","1071999","12625234500"
"311060","엘에이티","3800","4700","900","23.68","10301","41385045"
"073110","엘엠에스","7960","8070","110","1.38","297226","2373691580"
"083310","엘오티베큠","12450","11600","-850","-6.83","2263025","27971708150"
"037950","엘컴텍","1150","1180","30","2.61","7116612","8291091000"
"170920","엘티씨","8130","8980","850","10.46","301423","2497061050"
"058630","엠게임","7590","8260","670","8.83","6602937","52740537210"
"058970","엠로","16500","15250","-1250","-7.58","740322","11997809900"
"019590","엠벤처투자","1205","1475","270","22.41","16332938","23322945825"
"169330","엠브레인","3545","3585","40","1.13","552429","1953717175"
"097520","엠씨넥스","31050","34600","3550","11.43","1131217","36885269000"
"179290","엠아이텍","9170","12250","3080","33.59","11906538","126125734080"
"009780","엠에스씨","5790","6070","280","4.84","141424","843795460"
"123040","엠에스오토텍","4295","4930","635","14.78","2602779","12483709675"
"323230","엠에프엠코리아","889","940","51","5.74","1033677","949754643"
"033160","엠케이전자","11000","13350","2350","21.36","3749122","44976131100"
"347890","엠투아이","8250","9420","1170","14.18","2607551","23585590300"
"033310","엠투엔","6400","8630","2230","34.84","17759754","147388557810"
"259630","엠플러스","14750","16600","1850","12.54","2250203","36290689450"
"065150","엠피대산","569","562","-7","-1.23","2589459","1463385256"
"115960","연우","17250","17900","650","3.77","497631","8630113850"
"090740","연이비앤티","2105","2105","0","0.00","0","0"
"060850","영림원소프트랩","8630","10550","1920","22.25","3533899","36050448520"
"014440","영보화학","3625","4235","610","16.83","5138976","21225758205"
"007530","영신금속","2705","2675","-30","-1.11","442477","1186013705"
"143540","영우디에스피","1530","1930","400","26.14","110632711","220337832450"
"111770","영원무역","39650","41950","2300","5.80","1978741","79441010328"
"009970","영원무역홀딩스","47300","47100","-200","-0.42","383459","18287863150"
"003520","영진약품","3555","3605","50","1.41","7206202","26040356085"
"000670","영풍","511000","592000","81000","15.85","19958","10726488500"
"036560","영풍정밀","8560","9210","650","7.59","1802754","17089477390"
"006740","영풍제지","7280","7280","0","0.00","5141383","38215587440"
"012280","영화금속","1100","1205","105","9.55","4219135","4874299630"
"265560","영화테크","12700","13950","1250","9.84","2875373","38507213450"
"012160","영흥","785","848","63","8.03","2665937","2194195288"
"036000","예림당","1900","1995","95","5.00","379118","726104555"
"250930","예선테크","1325","1455","130","9.81","5902092","8744902765"
"053280","예스24","6370","6750","380","5.97","1263323","8376255040"
"015360","예스코홀딩스","34600","35150","550","1.59","57138","2010693750"
"122640","예스티","6760","9120","2360","34.91","1930664","15555710350"
"900300","오가닉티코스메틱","348","331","-17","-4.89","22896635","7713219001"
"045060","오공","3655","3805","150","4.10","6278186","25536147535"
"080520","오디텍","5480","5650","170","3.10","1192504","6559088350"
"007310","오뚜기","433500","466500","33000","7.61","275960","124132977000"
"039830","오로라","7940","8750","810","10.20","486724","4055900530"
"322310","오로스테크놀로지","15150","14850","-300","-1.98","384520","5643577950"
"046120","오르비텍","6970","7420","450","6.46","69332774","491399503930"
"014940","오리엔탈정공","2805","3370","565","20.14","8323110","27618064435"
"002630","오리엔트바이오","760","841","81","10.66","8973738","7381731210"
"065500","오리엔트정공","1595","1900","305","19.12","2900728","5065073815"
"271560","오리온","106000","105500","-500","-0.47","2957876","305513686000"
"001800","오리온홀딩스","14950","14950","0","0.00","1412318","21162560750"
"010470","오리콤","6850","6480","-370","-5.40","2181168","14079360430"
"352910","오비고","10950","11500","550","5.02","2733252","31470995400"
"053980","오상자이엘","6080","6590","510","8.39","22011780","165097530270"
"052420","오성첨단소재","2150","2150","0","0.00","0","0"
"241790","오션브릿지","11000","12500","1500","13.64","724615","8906279200"
"329020","오션스톤","1485","1300","-185","-12.46","19095","26965735"
"039200","오스코텍","28150","28050","-100","-0.36","3048123","86953306050"
"226400","오스테오닉","3025","2915","-110","-3.64","759617","2271424330"
"031510","오스템","1805","2015","210","11.63","16548898","35335240785"
"048260","오스템임플란트","99300","110400","11100","11.18","3801809","395835062750"
"138080","오이솔루션","22150","23800","1650","7.45","436904","10122330400"
"080580","오킨스전자","21450","20150","-1300","-6.06","1507624","30509511300"
"067170","오텍","7660","7480","-180","-2.35","1256143","9804782370"
"353590","오토앤","11550","13700","2150","18.61","10108546","132498050700"
"173130","오파스넷","6140","5470","-670","-10.91","9237696","51283105760"
"049480","오픈베이스","2825","3070","245","8.67","16914379","51822912325"
"309930","오하임아이엔티","3120","3590","470","15.06","8968308","31599473940"
"244460","올리패스","5800","5780","-20","-0.34","4714539","27016803580"
"226950","올릭스","23500","23200","-300","-1.28","2297522","52926254100"
"057540","옴니시스템","2635","2250","-385","-14.61","54488883","139198378365"
"131030","옵투스제약","6160","6630","470","7.63","939201","6413614190"
"082210","옵트론텍","5340","5640","300","5.62","5947930","33172601010"
"109080","옵티시스","11800","14050","2250","19.07","2188196","31483171750"
"153710","옵티팜","8620","10050","1430","16.59","6070414","60817639080"
"321820","와이더플래닛","7500","7900","400","5.33","319575","2473616370"
"122990","와이솔","8590","8980","390","4.54","856310","7477871030"
"232140","와이아이케이","4140","4290","150","3.62","1445770","6036911600"
"065530","와이어블","2680","2945","265","9.89","15245915","46243227725"
"067900","와이엔텍","9220","10000","780","8.46","2797485","28505131450"
"155650","와이엠씨","6210","6000","-210","-3.38","709581","4390991140"
"273640","와이엠텍","15000","16750","1750","11.67","652578","10342801900"
"251370","와이엠티","12600","15150","2550","20.24","3473791","50962547200"
"066430","와이오엠","2005","1885","-120","-5.99","1085236","2140968395"
"193250","와이제이엠게임즈","2100","2150","50","2.38","17446396","37881176195"
"273060","와이즈버즈","1290","1295","5","0.39","1715584","2255774130"
"019210","와이지-원","6650","7450","800","12.03","2277852","15617673180"
"122870","와이지엔터테인먼트","49650","58900","9250","18.63","4696428","257430181750"
"011690","와이투솔루션","800","715","-85","-10.63","24483752","17060589265"
"332570","와이팜","4660","4760","100","2.15","1359820","6480648670"
"079000","와토스코리아","5630","6570","940","16.70","4774781","31774702440"
"070960","용평리조트","4005","4045","40","1.00","1195660","4737801325"
"316140","우리금융지주","11600","12150","550","4.74","52156007","613220980914"
"032820","우리기술","2225","2100","-125","-5.62","62795362","131244530505"
"041190","우리기술투자","5530","6330","800","14.47","69453929","435500643320"
"115440","우리넷","8730","9000","270","3.09","1595823","14119061660"
"046970","우리로","1485","1605","120","8.08","9340764","14542646815"
"082850","우리바이오","3175","3785","610","19.21","86347325","350143129940"
"215360","우리산업","14700","16300","1600","10.88","4536002","73077716750"
"072470","우리산업홀딩스","4450","5570","1120","25.17","46784244","256723250870"
"073560","우리손에프앤지","1965","1990","25","1.27","16291681","31547911430"
"037400","우리엔터프라이즈","2310","2625","315","13.64","11498826","30177187075"
"153490","우리이앤엘","1195","1355","160","13.39","6843007","9012245175"
"010050","우리종금","884","972","88","9.95","56636276","52341751195"
"101170","우림피티에스","8950","9120","170","1.90","47662095","430948365090"
"006980","우성","24900","25150","250","1.00","177053","4331730100"
"066590","우수AMS","3810","4010","200","5.25","7060108","28447245240"
"017370","우신시스템","2470","2670","200","8.10","2398635","6289095895"
"103840","우양","3800","4010","210","5.53","1600491","6420221425"
"046940","우원개발","4305","5490","1185","27.53","18367999","90653472265"
"215380","우정바이오","4970","5060","90","1.81","2960798","15549218865"
"065680","우주일렉트로","21400","21500","100","0.47","894169","18824508400"
"105840","우진","11900","13700","1800","15.13","29936874","374892498500"
"018620","우진비앤지","2115","2180","65","3.07","20186554","42880564095"
"010400","우진아이엔에스","6020","6620","600","9.97","787004","5366507200"
"049800","우진플라임","3385","3900","515","15.21","701170","2538699160"
"016880","웅진","1395","1500","105","7.53","9743205","14429685310"
"095720","웅진씽크빅","2380","2595","215","9.03","4490867","11494855115"
"005820","원림","22800","25300","2500","10.96","94738","2409056900"
"307280","원바이오젠","1625","1640","15","0.92","1144987","1866417710"
"053080","원방테크","10550","12050","1500","14.22","1863699","21368299150"
"032940","원익","3675","3860","185","5.03","350756","1322631645"
"240810","원익IPS","28700","29300","600","2.09","8107083","243175012860"
"074600","원익QnC","26600","24800","-1800","-6.77","9807358","243962569900"
"104830","원익머트리얼즈","30850","31700","850","2.76","1893087","57891086350"
"014190","원익큐브","2460","2755","295","11.99","8713287","23658273720"
"131390","원익피앤이","20650","21000","350","1.69","2301343","48207432700"
"030530","원익홀딩스","3835","3990","155","4.04","3148345","12264920650"
"012620","원일특강","11500","12100","600","5.22","3638239","44496222600"
"382840","원준","41368","35400","-5968","-14.43","9277269","379111473900"
"336570","원텍","3025","2975","-50","-1.65","23734967","72706040635"
"376980","원티드랩","21900","23250","1350","6.16","2694238","64202248550"
"122830","원포유","1890","1900","10","0.53","314392","589934730"
"008370","원풍","4880","5010","130","2.66","346610","1717656805"
"008290","원풍물산","736","842","106","14.40","7831693","6899954860"
"101160","월덱스","18550","19000","450","2.43","2673252","50835677250"
"336060","웨이버스","1720","1740","20","1.16","6665747","11607669180"
"095270","웨이브일렉트로","5580","5430","-150","-2.69","863910","4672425800"
"010600","웰바이오텍","1650","1715","65","3.94","43955543","78781890050"
"065950","웰크론","3355","3580","225","6.71","10711307","39480438415"
"076080","웰크론한텍","2935","4400","1465","49.91","100671888","424839270575"
"196700","웹스","3440","3980","540","15.70","46213325","180009007590"
"069080","웹젠","18700","20750","2050","10.96","1425721","27905907400"
"053580","웹케시","16450","20450","4000","24.32","1088124","20266498150"
"071460","위니아","2790","2545","-245","-8.78","1821242","4684177355"
"377460","위니아에이드","11700","9150","-2550","-21.79","7371257","73967658810"
"044340","위닉스","12150","12950","800","6.58","641102","7874318650"
"330350","위더스제약","8530","9000","470","5.51","606061","5443498230"
"348350","위드텍","15300","15100","-200","-1.31","210404","3184970750"
"112040","위메이드","59100","70900","11800","19.97","21830913","1468990516300"
"101730","위메이드맥스","18150","22750","4600","25.34","23221298","489630549700"
"123420","위메이드플레이","23550","28300","4750","20.17","4581036","121985032250"
"065370","위세아이텍","11350","11150","-200","-1.76","401295","4577456550"
"140660","위월드","2400","2495","95","3.96","10413","24403000"
"038620","위즈코프","1130","1200","70","6.19","25628481","30754313015"
"299900","위지윅스튜디오","21750","25500","3750","17.24","9381324","221493854750"
"036090","위지트","839","1025","186","22.17","129198677","137022840207"
"136540","윈스","13600","14300","700","5.15","412330","5725018400"
"320000","윈텍","2125","2315","190","8.94","6339744","15192243545"
"097800","윈팩","1400","1460","60","4.29","1394859","1986386075"
"192390","윈하이텍","3615","4020","405","11.20","2083159","8033425065"
"313760","윌링스","11100","11650","550","4.95","1570292","17950223950"
"008600","윌비스","931","1000","69","7.41","7986074","7781243333"
"900340","윙입푸드","1365","1200","-165","-12.09","24657024","31683600915"
"033270","유나이티드제약","23550","25650","2100","8.92","1548469","39954951150"
"064510","유네코","2750","2750","0","0.00","0","0"
"014830","유니드","89000","96100","7100","7.98","1541998","146367869300"
"036200","유니셈","7360","7370","10","0.14","13655646","103215222580"
"018000","유니슨","2370","2780","410","17.30","22890380","58454149010"
"000910","유니온","5790","6460","670","11.57","25612269","165918002640"
"047400","유니온머티리얼","2230","3460","1230","55.16","273919228","906542848185"
"203450","유니온커뮤니티","2795","3260","465","16.64","4471399","14882730385"
"011330","유니켐","1200","1190","-10","-0.83","1867333","2215977370"
"077500","유니퀘스트","9000","9200","200","2.22","1760518","16342883600"
"011320","유니크","6520","7070","550","8.44","13491227","90658101890"
"086390","유니테스트","17850","19200","1350","7.56","3582244","65767723300"
"241690","유니테크노","5650","5820","170","3.01","2874493","16449006750"
"142210","유니트론텍","3695","4010","315","8.53","1596782","6109281170"
"121060","유니포인트","1700","1745","45","2.65","54690","95889485"
"048430","유라테크","6900","7360","460","6.67","437719","3186014500"
"206650","유바이오로직스","15750","17100","1350","8.57","9747384","164662624500"
"089850","유비벨록스","14650","16350","1700","11.60","2073976","33059025150"
"084440","유비온","2235","2295","60","2.68","135739","306649820"
"032620","유비케어","5360","6110","750","13.99","9940245","61647132670"
"264450","유비쿼스","14850","17400","2550","17.17","471343","7604265550"
"078070","유비쿼스홀딩스","16600","16300","-300","-1.81","1052486","17488876150"
"002920","유성기업","2820","2970","150","5.32","279803","808080225"
"024800","유성티엔에스","2555","2705","150","5.87","869174","2234719160"
"000700","유수홀딩스","5920","6130","210","3.55","391334","2348273420"
"054930","유신","27250","27250","0","0.00","4314685","115208311600"
"069330","유아이디","2060","2230","170","8.25","2079015","4576453180"
"049520","유아이엘","2550","3070","520","20.39","521051","1484321270"
"367460","유안타제7호스팩","2480","2180","-300","-12.10","8867780","21308453095"
"367480","유안타제8호스팩","2150","2150","0","0.00","493678","1064511235"
"003470","유안타증권","2675","2945","270","10.09","2348182","6487576145"
"003475","유안타증권우","2880","3235","355","12.33","90598","271998880"
"263770","유에스티","3025","3310","285","9.42","391303","1222173585"
"337840","유엑스엔","17400","19600","2200","12.64","58370","1060326850"
"072130","유엔젤","3180","3415","235","7.39","963006","3217373930"
"000220","유유제약","6470","6770","300","4.64","4751574","32809794100"
"000225","유유제약1우","8700","9420","720","8.28","1328868","12891174990"
"000227","유유제약2우B","17000","17250","250","1.47","22410","398754350"
"388720","유일로보틱스","21100","28600","7500","35.55","53308760","1438922979700"
"340930","유일에너테크","13250","15500","2250","16.98","1901294","28682043050"
"023410","유진기업","3905","4100","195","4.99","4122810","16154704780"
"056080","유진로봇","5020","5380","360","7.17","9050743","48040907355"
"373340","유진스팩6호","2265","2250","-15","-0.66","832091","1951605220"
"388800","유진스팩7호","2180","2155","-25","-1.15","189087","409599230"
"413630","유진스팩8호","2115","2120","5","0.24","199534","422941580"
"084370","유진테크","29650","28750","-900","-3.04","2654263","79394075938"
"001200","유진투자증권","2640","2925","285","10.80","3037885","8540038865"
"178780","유테크","1730","1730","0","0.00","0","0"
"221800","유투바이오","28750","29000","250","0.87","1698","43481400"
"179900","유티아이","17500","22850","5350","30.57","3376081","77203026700"
"263050","유틸렉스","6700","5300","-1400","-20.90","33072325","179830774150"
"000100","유한양행","57300","59000","1700","2.97","3084978","177787267800"
"000105","유한양행우","55200","56800","1600","2.90","10251","575547200"
"003460","유화증권","2340","2500","160","6.84","232688","552739530"
"003465","유화증권우","2535","2590","55","2.17","10556","27511205"
"191410","육일씨엔에쓰","3180","3430","250","7.86","719070","2463674470"
"008730","율촌화학","19000","26150","7150","37.63","2370275","50501411700"
"072770","율호","1385","1625","240","17.33","8943288","13368728420"
"008250","이건산업","8690","9500","810","9.32","979349","8659617010"
"039020","이건홀딩스","3910","3945","35","0.90","3843591","14635685145"
"025820","이구산업","2985","3320","335","11.22","4207500","13023416595"
"067920","이글루","5320","5690","370","6.95","1369137","7962792310"
"044960","이글벳","6200","6730","530","8.55","11527534","76799630900"
"303530","이노뎁","14600","14150","-450","-3.08","980568","14646359700"
"302430","이노메트리","9550","12000","2450","25.65","400948","4385660150"
"279060","이노벡스","4665","4865","200","4.29","65289","309515060"
"214320","이노션","45850","43350","-2500","-5.45","2668300","120409023850"
"056090","이노시스","2220","4550","2330","104.95","62823033","666231933615"
"073490","이노와이어리스","28000","29600","1600","5.71","862025","25140000400"
"215790","이노인스트루먼트","1665","1705","40","2.40","1648393","2741294345"
"344860","이노진","7000","7390","390","5.57","7996","56083140"
"246960","이노테라피","9150","9510","360","3.93","56685","528788850"
"088390","이녹스","21200","25050","3850","18.16","1774898","42921727100"
"272290","이녹스첨단소재","34050","33500","-550","-1.62","6880531","236945858550"
"053350","이니텍","3930","4195","265","6.74","2449663","10658179515"
"041520","이라이콤","5410","5770","360","6.65","482105","2671384830"
"264850","이랜시스","2925","3260","335","11.45","14981229","51138190840"
"054210","이랜텍","18950","19450","500","2.64","8839179","171744239800"
"164060","이루다","5320","5800","480","9.02","6003274","33685897225"
"065440","이루온","2410","3195","785","32.57","233536399","694051086055"
"088260","이리츠코크렙","5780","5820","40","0.69","1268732","7106757790"
"139480","이마트","106500","108500","2000","1.88","4563842","493373740850"
"115610","이미지스","2565","2610","45","1.75","2081806","5421073005"
"349720","이베스트스팩5호","2100","2105","5","0.24","115647","242657010"
"078020","이베스트투자증권","6470","6800","330","5.10","1129355","7423981480"
"131400","이브이첨단소재","1895","1800","-95","-5.01","40268741","76539368350"
"208850","이비테크","6060","5990","-70","-1.16","3226","17878630"
"351330","이삭엔지니어링","11100","11650","550","4.95","1050801","12185037750"
"080010","이상네트웍스","5490","5770","280","5.10","1194472","6629807310"
"379390","이성씨엔아이","12050","11800","-250","-2.07","328","3350550"
"086890","이수앱지스","8190","8260","70","0.85","14464219","124800561450"
"007660","이수페타시스","6870","6970","100","1.46","25512937","186449770910"
"005950","이수화학","14500","16150","1650","11.38","6690432","101727082050"
"015020","이스타코","1275","1500","225","17.65","39243826","57437147050"
"047560","이스트소프트","9680","9940","260","2.69","1075950","10627137470"
"900110","이스트아시아홀딩스","225","228","3","1.33","93107532","21199088835"
"067010","이씨에스","3870","4155","285","7.36","13990605","65598393650"
"093230","이아이디","1280","1510","230","17.97","29778227","43592082000"
"341310","이앤에치","1700","1695","-5","-0.29","48590","75624610"
"101360","이엔드디","23350","27950","4600","19.70","2090171","56311746450"
"102710","이엔에프테크놀로지","27650","29300","1650","5.97","1130795","32221835000"
"066980","이엔코퍼레이션","2915","3210","295","10.12","6697835","21191476355"
"074610","이엔플러스","3075","3165","90","2.93","13031405","42410267575"
"063760","이엘피","5340","5380","40","0.75","990886","5370990220"
"123570","이엠넷","5340","6160","820","15.36","1639605","9379183740"
"083470","이엠앤아이","3220","3220","0","0.00","0","0"
"095190","이엠코리아","2855","3300","445","15.59","4546349","14284513595"
"091120","이엠텍","27150","27000","-150","-0.55","1393312","39180703450"
"232530","이엠티","3050","4485","1435","47.05","59482","154939305"
"102460","이연제약","23250","27250","4000","17.20","8367151","228348226750"
"039030","이오테크닉스","77800","78800","1000","1.29","1615380","125247758700"
"294090","이오플로우","19350","20600","1250","6.46","1629508","32213745050"
"088290","이원컴포텍","8640","9100","460","5.32","2756094","23711375120"
"084680","이월드","1795","1995","200","11.14","33961375","69484868290"
"181340","이즈미디어","2705","2705","0","0.00","0","0"
"353810","이지바이오","4350","4535","185","4.25","26461851","122767460815"
"350520","이지스레지던스리츠","4870","4625","-245","-5.03","1400381","6401539520"
"334890","이지스밸류리츠","5140","5050","-90","-1.75","1351475","6677597900"
"099750","이지케어텍","24500","25050","550","2.24","414685","10610686350"
"377330","이지트로닉스","13350","15600","2250","16.85","8026040","123413441950"
"035810","이지홀딩스","3650","3660","10","0.27","15775352","57207891405"
"160600","이큐셀","3100","3100","0","0.00","0","0"
"092130","이크레더블","17100","17150","50","0.29","154567","2620758200"
"096040","이트론","183","200","17","9.29","278344997","54256946208"
"134060","이퓨쳐","6480","6450","-30","-0.46","341034","2298457140"
"001840","이화공영","5880","6630","750","12.76","9703621","63213903810"
"000760","이화산업","15000","16100","1100","7.33","23092","358437950"
"024810","이화전기","1130","959","-171","-15.13","63174637","62399281057"
"014990","인디에프","780","777","-3","-0.38","1029250","786604160"
"041830","인바디","23100","25750","2650","11.47","680438","16832985200"
"352940","인바이오","5300","6010","710","13.40","612557","3566351120"
"101140","인바이오젠","1830","2190","360","19.67","18496993","42966137170"
"216400","인바이츠바이오코아","8800","8900","100","1.14","6886","60962280"
"079950","인베니아","2005","2100","95","4.74","1806418","3821215190"
"277410","인산가","2010","2155","145","7.21","2367842","4921097840"
"060150","인선이엔티","8490","9620","1130","13.31","14145221","138378607210"
"033230","인성정보","2185","2340","155","7.09","24839574","60585905410"
"006490","인스코비","2195","2105","-90","-4.10","11983037","25552923750"
"037330","인지디스플레","1830","2005","175","9.56","981288","1873155325"
"023800","인지컨트롤스","7260","8280","1020","14.05","1919994","15486601350"
"034590","인천도시가스","25000","27600","2600","10.40","1095397","31562525400"
"211050","인카금융서비스","7950","7620","-330","-4.15","2155768","15660032180"
"083640","인콘","1055","1330","275","26.07","207968601","327349271694"
"216050","인크로스","17700","16450","-1250","-7.06","1655219","26255446650"
"049070","인탑스","28000","31750","3750","13.39","9626273","297153376750"
"119610","인터로조","26750","28600","1850","6.92","1286552","36389285900"
"017250","인터엠","1210","1290","80","6.61","1446520","1867272175"
"129260","인터지스","2810","3030","220","7.83","1783935","5118293135"
"051370","인터플렉스","12700","12650","-50","-0.39","2067436","26633259900"
"064290","인텍플러스","19200","18300","-900","-4.69","2808893","52919953250"
"189300","인텔리안테크","62600","69200","6600","10.54","972060","63822023800"
"150840","인트로메딕","5850","5850","0","0.00","0","0"
"048530","인트론바이오","10450","12450","2000","19.14","8601541","97616960750"
"023810","인팩","8580","8900","320","3.73","474111","4217094420"
"175140","인포마크","7040","7000","-40","-0.57","278821","2021980830"
"115310","인포바인","30300","37200","6900","22.77","8863144","324490909300"
"039290","인포뱅크","13750","14900","1150","8.36","5206889","75923720600"
"071200","인피니트헬스케어","5110","5970","860","16.83","7556594","45820217470"
"101930","인화정공","13750","14950","1200","8.73","579189","8084192000"
"249420","일동제약","33200","39850","6650","20.03","107200199","4663867018700"
"000230","일동홀딩스","25850","31950","6100","23.60","35524328","1115017749000"
"013360","일성건설","3590","4090","500","13.93","31756084","124806270070"
"003120","일성신약","77000","77600","600","0.78","11173","866530100"
"333430","일승","3240","3990","750","23.15","33846552","124990455935"
"068330","일신바이오","3430","3430","0","0.00","0","0"
"003200","일신방직","95500","104000","8500","8.90","110532","11176340900"
"007110","일신석재","1400","1565","165","11.79","10815124","16112828690"
"058450","일야","604","654","50","8.28","6476703","4050678943"
"007570","일양약품","23250","23850","600","2.58","1891410","45703205200"
"007575","일양약품우","25650","25550","-100","-0.39","34445","910542250"
"008500","일정실업","18400","24100","5700","30.98","154487","3359023600"
"019540","일지테크","2475","2800","325","13.13","528284","1368334350"
"081000","일진다이아","19300","23000","3700","19.17","662584","13675134450"
"020760","일진디스플","2135","2005","-130","-6.09","17905802","39414100730"
"020150","일진머티리얼즈","69300","75500","6200","8.95","5961375","428938405700"
"103590","일진전기","6950","5940","-1010","-14.53","18328815","120817645570"
"094820","일진파워","16700","19300","2600","15.57","9694841","167723956600"
"271940","일진하이솔루스","32000","38000","6000","18.75","1693634","57587444550"
"015860","일진홀딩스","6250","6120","-130","-2.08","30921737","206204282780"
"226320","잇츠한불","16250","16650","400","2.46","613936","9964960450"
"950140","잉글우드랩","4810","4790","-20","-0.42","4655548","24123681145"
"049550","잉크테크","6780","6820","40","0.59","309737","2083607690"
"254120","자비스","1795","1865","70","3.90","8212479","15488050015"
"043910","자연과환경","1445","1740","295","20.42","138764265","220920203010"
"234920","자이글","2910","2800","-110","-3.78","260467","708788040"
"289220","자이언트스텝","22950","27550","4600","20.04","11997454","322305619050"
"317400","자이에스앤디","5940","8090","2150","36.20","21950780","181482169670"
"033240","자화전자","23900","24300","400","1.67","6322969","161318493650"
"174880","장원테크","1650","1655","5","0.30","1158576","1942072985"
"049630","재영솔루텍","698","787","89","12.75","4362030","3356084437"
"000950","전방","55500","54100","-1400","-2.52","27246","1514406600"
"110020","전진바이오팜","4480","3985","-495","-11.05","415684","1834769965"
"208140","정다운","2285","2405","120","5.25","3182430","7461517585"
"040420","정상제이엘에스","7460","7590","130","1.74","255208","1908593980"
"045510","정원엔시스","1965","2190","225","11.45","141393133","321442466690"
"217190","제너셈","6230","6260","30","0.48","359935","2225624730"
"095700","제넥신","32900","33400","500","1.52","2490575","82542597950"
"072520","제넨바이오","2290","2200","-90","-3.93","13286717","33661666685"
"122310","제노레이","8070","8920","850","10.53","1868345","16718796050"
"361390","제노코","21400","26150","4750","22.20","3512209","84519623700"
"066830","제노텍","3595","3000","-595","-16.55","11562","35839725"
"187420","제노포커스","5570","6610","1040","18.67","26860812","200160511680"
"225220","제놀루션","12350","12700","350","2.83","5430106","75810236700"
"123330","제닉","3970","5100","1130","28.46","19211352","103728545530"
"159580","제로투세븐","6890","7230","340","4.93","3191504","22481465190"
"147830","제룡산업","2990","3125","135","4.52","1892955","5686127575"
"033100","제룡전기","6980","7400","420","6.02","14621275","107934265670"
"079370","제우스","22900","22750","-150","-0.66","3025130","70708210450"
"054950","제이브이엠","17000","21750","4750","27.94","3368633","66852993550"
"023440","제이스코홀딩스","2350","1995","-355","-15.11","3497875","7828259405"
"090470","제이스텍","5720","6850","1130","19.76","2933194","19342805140"
"287410","제이시스메디칼","7340","7960","620","8.45","9576608","73428403480"
"137950","제이씨케미칼","7820","8550","730","9.34","16150717","139806597970"
"033320","제이씨현시스템","4905","5270","365","7.44","1523688","8014566600"
"348950","제이알글로벌리츠","4505","4680","175","3.88","16024116","72168039315"
"204270","제이앤티씨","5040","5190","150","2.98","389817","2019221980"
"194370","제이에스코퍼레이션","17500","17350","-150","-0.86","1645921","28157367800"
"026040","제이에스티나","2995","3045","50","1.67","840941","2451099050"
"126880","제이엔케이히터","5530","6060","530","9.58","8001868","46959054010"
"322510","제이엘케이","4695","5100","405","8.63","414923","2030692655"
"254160","제이엠멀티","5490","4370","-1120","-20.40","10510","45596420"
"033050","제이엠아이","1100","1160","60","5.45","2614227","2948850265"
"094970","제이엠티","3310","3625","315","9.52","1758202","6130985230"
"058420","제이웨이","2160","2160","0","0.00","0","0"
"025620","제이준코스메틱","972","907","-65","-6.69","10052096","9700704913"
"089790","제이티","6660","7040","380","5.71","2303391","16780293680"
"030000","제일기획","23550","22400","-1150","-4.88","6984181","156488641748"
"052670","제일바이오","1875","1875","0","0.00","1431577","2647436745"
"271980","제일약품","21150","23050","1900","8.98","2216749","54828635550"
"001560","제일연마","9060","9390","330","3.64","854865","7895409590"
"199820","제일전기공업","11950","12650","700","5.86","281444","3334729900"
"038010","제일테크노스","7070","7890","820","11.60","3724453","26391946560"
"002620","제일파마홀딩스","12050","13300","1250","10.37","625232","8428801900"
"276730","제주맥주","2170","2410","240","11.06","28256633","68116733440"
"080220","제주반도체","4210","4835","625","14.85","40994770","198399655200"
"006220","제주은행","4395","5320","925","21.05","27889186","166420729665"
"089590","제주항공","15700","15450","-250","-1.59","4334482","65461603291"
"216080","제테마","13800","15650","1850","13.41","501997","7434813800"
"229000","젠큐릭스","9280","9720","440","4.74","590841","5772230510"
"248020","젬","2500","2500","0","0.00","0","0"
"082270","젬백스","13050","15150","2100","16.09","3044657","42089943050"
"064800","젬백스링크","1310","1400","90","6.87","8288620","11340021585"
"044060","조광ILI","2441","1580","-861","-35.27","157617945","531067767055"
"004910","조광페인트","6100","8010","1910","31.31","1717107","12271721850"
"004700","조광피혁","42800","44650","1850","4.32","12837","559672800"
"001550","조비","19500","20800","1300","6.67","812742","15920738150"
"000480","조선내화","79400","77600","-1800","-2.27","22639","1755853600"
"120030","조선선재","152500","159500","7000","4.59","3625803","578323048500"
"034940","조아제약","2875","2950","75","2.61","3206076","9610652790"
"067000","조이시티","4770","5140","370","7.76","34162655","180036718225"
"018470","조일알미늄","1615","2230","615","38.08","205513313","446474278665"
"002600","조흥","174000","183000","9000","5.17","1282","226772500"
"185750","종근당","88800","90900","2100","2.36","406349","36746178200"
"063160","종근당바이오","28800","30400","1600","5.56","539958","16437888550"
"001630","종근당홀딩스","56400","61000","4600","8.16","86160","5053211000"
"033340","좋은사람들","1055","1055","0","0.00","0","0"
"036930","주성엔지니어링","16650","15850","-800","-4.80","20807014","344827470300"
"044380","주연테크","818","890","72","8.80","3800069","3324125401"
"239340","줌인터넷","4005","4315","310","7.74","13064091","57378030575"
"051980","중앙디앤엠","712","698","-14","-1.97","5343351","3912740969"
"072020","중앙백신","12150","12700","550","4.53","337183","4247544200"
"000440","중앙에너비스","21550","21250","-300","-1.39","1556420","33208995500"
"078650","지나인제약","2120","2120","0","0.00","0","0"
"228760","지노믹트리","13350","13150","-200","-1.50","2523638","34054170000"
"314130","지놈앤컴퍼니","18000","21350","3350","18.61","2466348","50944403850"
"013890","지누스","50200","47800","-2400","-4.78","1088597","51557367400"
"389030","지니너스","4103","2955","-1148","-27.98","23553132","110601070535"
"043610","지니뮤직","4100","4475","375","9.15","30063082","147699425095"
"263860","지니언스","7950","9040","1090","13.71","593122","5138685540"
"303030","지니틱스","2320","2650","330","14.22","18535815","47909773575"
"036180","지더블유바이텍","782","878","96","12.28","125246877","143818435953"
"208350","지란지교시큐리티","3835","3905","70","1.83","183959","711591125"
"144510","지씨셀","59200","65600","6400","10.81","2714498","175136241400"
"382480","지아이텍","3005","3440","435","14.48","8930459","29007165410"
"382800","지앤비에스엔지니어링","11650","12100","450","3.86","669224","8089446800"
"299480","지앤이헬스케어","899","896","-3","-0.33","1331","1164102"
"051160","지어소프트","12200","12650","450","3.69","1409221","17109150350"
"053050","지에스이","4565","5310","745","16.32","95860390","494344355440"
"119850","지엔씨에너지","4320","4525","205","4.75","14430522","66727406255"
"270520","지엔원에너지","2565","2755","190","7.41","11854738","32950266220"
"065060","지엔코","567","573","6","1.06","2457366","1395753625"
"204840","지엘팜텍","896","958","62","6.92","10630995","10423753832"
"013870","지엠비코리아","5480","5890","410","7.48","647644","3624652180"
"071320","지역난방공사","31100","33300","2200","7.07","42328","1351199550"
"311320","지오엘리먼트","18200","19900","1700","9.34","2215753","44902008450"
"035000","지투알","5800","6000","200","3.45","152225","909354970"
"388050","지투파워","7388","15500","8112","109.80","26505409","1179785409900"
"219750","지티지웰니스","1425","1425","0","0.00","0","0"
"088790","진도","2920","3335","415","14.21","1085891","3521538405"
"018120","진로발효","23550","24150","600","2.55","112808","2716727850"
"109820","진매트릭스","7830","7680","-150","-1.92","70222296","621775258080"
"086060","진바이오텍","4825","4905","80","1.66","1197928","5784896815"
"036890","진성티이씨","10200","10350","150","1.47","4548489","47188830440"
"363250","진시스템","10150","9830","-320","-3.15","529516","5454734710"
"003780","진양산업","7340","7660","320","4.36","1353856","10109316000"
"007370","진양제약","5990","6170","180","3.01","484980","3009470250"
"010640","진양폴리","5760","6340","580","10.07","1663740","10097975260"
"100250","진양홀딩스","3635","3575","-60","-1.65","865460","3091316760"
"051630","진양화학","3800","4010","210","5.53","776752","2959615320"
"272450","진에어","14550","14750","200","1.37","4248788","60209293550"
"011000","진원생명과학","11150","13250","2100","18.83","70990985","1029528025150"
"250030","진코스텍","4250","4395","145","3.41","25453","102904630"
"002780","진흥기업","1695","1815","120","7.08","23736646","40583039780"
"002787","진흥기업2우B","14900","14900","0","0.00","13517","194553300"
"002785","진흥기업우B","5430","5610","180","3.31","28350","151565130"
"233990","질경이","799","689","-110","-13.77","81968","56912881"
"085660","차바이오텍","15000","16800","1800","12.00","5171925","81846191000"
"261780","차백신연구소","6390","7540","1150","18.00","74678848","595909764140"
"009310","참엔지니어링","837","848","11","1.31","2920642","2420904422"
"158310","참존글로벌","1680","1680","0","0.00","0","0"
"094850","참좋은여행","9700","10100","400","4.12","1276649","12277255630"
"004650","창해에탄올","12000","12850","850","7.08","1808559","22987887000"
"278280","천보","216100","252900","36800","17.03","1205964","282180991500"
"000650","천일고속","63400","66000","2600","4.10","6010","390645600"
"140290","청광건설","592","597","5","0.84","5598","3017261"
"362320","청담글로벌","9150","10700","1550","16.94","90450087","932578363510"
"066360","체리부로","1180","1195","15","1.27","512964","605600890"
"033250","체시스","1030","1110","80","7.77","3045063","3173362027"
"047820","초록뱀미디어","15500","17250","1750","11.29","2873184","46838574250"
"052300","초록뱀컴퍼니","820","891","71","8.66","104798296","102994157163"
"118000","초록뱀헬스케어","974","936","-38","-3.90","13585560","13670703551"
"094360","칩스앤미디어","15400","19000","3600","23.38","2765029","47643251350"
"016790","카나리아바이오","35000","34850","-150","-0.43","42971755","1754125828550"
"016920","카스","2320","2460","140","6.03","34090637","88807369785"
"284620","카이노스메드","9353","7190","-2163","-23.13","2695259","21665296110"
"035720","카카오","71800","83900","12100","16.85","39151225","2964349121176"
"293490","카카오게임즈","49000","59700","10700","21.84","22922536","1247454786700"
"323410","카카오뱅크","31300","32400","1100","3.51","31502847","984275934650"
"377300","카카오페이","65300","74500","9200","14.09","11752016","801593673200"
"042000","카페24","12500","13450","950","7.60","1466199","18892289850"
"006380","카프로","2880","3025","145","5.03","1648851","4742764755"
"317530","캐리소프트","6360","6380","20","0.31","1959426","14456788000"
"071850","캐스텍코리아","1920","2120","200","10.42","558481","1115532065"
"050110","캠시스","2300","2715","415","18.04","427575843","1119594531755"
"223310","커머스마이너","3320","3320","0","0.00","0","0"
"109070","컨버즈","4100","4100","0","0.00","0","0"
"900310","컬러레이","1010","1050","40","3.96","5869293","5887573642"
"078340","컴투스","75100","86800","11700","15.58","3544271","282921994900"
"063080","컴투스홀딩스","53600","63400","9800","18.28","5212743","309756260800"
"307930","컴퍼니케이","6050","6390","340","5.62","1065995","6738139410"
"079190","케스피온","1275","1370","95","7.45","4343378","5820892485"
"263700","케어랩스","6220","6710","490","7.88","4020884","28358519200"
"214370","케어젠","99600","143500","43900","44.08","2197936","277682847200"
"221980","케이디켐","14250","14650","400","2.81","1265335","19487732600"
"001620","케이비아이동국실업","603","668","65","10.78","1816608","1167101706"
"342550","케이비제20호스팩","2290","2290","0","0.00","0","0"
"424140","케이비제21호스팩","2105","2110","5","0.24","604357","1274647705"
"192250","케이사인","1760","2050","290","16.48","49805810","101169497765"
"029460","케이씨","20000","18000","-2000","-10.00","660155","12439883800"
"115500","케이씨에스","6270","6780","510","8.13","11084810","77872961100"
"281820","케이씨텍","17900","16500","-1400","-7.82","595486","10274783250"
"089150","케이씨티","5550","5720","170","3.06","5694039","32544437030"
"025880","케이씨피드","3795","3510","-285","-7.51","6426605","22742405425"
"093320","케이아이엔엑스","50000","57300","7300","14.60","254083","13859397250"
"073010","케이에스피","2160","2095","-65","-3.01","1515564","3136671310"
"105330","케이엔더블유","9170","10900","1730","18.87","780072","7791930090"
"272110","케이엔제이","11400","11050","-350","-3.07","378862","4196768800"
"039420","케이엘넷","2830","2990","160","5.65","5388075","16635730075"
"083550","케이엠","6410","7350","940","14.66","9623144","75781461900"
"032500","케이엠더블유","27150","31650","4500","16.57","3130285","96558037400"
"225430","케이엠제약","1570","1700","130","8.28","4266524","7564318640"
"102370","케이옥션","12300","7250","-5050","-41.06","24661190","225138661660"
"381970","케이카","20000","22350","2350","11.75","11580314","251574140350"
"145270","케이탑리츠","1075","1145","70","6.51","2750241","2926011290"
"036030","케이티알파","5290","6560","1270","24.01","31336886","209447728760"
"064820","케이프","4195","4750","555","13.23","8395644","41488083530"
"347140","케이프이에스제4호","2120","2100","-20","-0.94","81904","172205975"
"256940","케이피에스","5710","6280","570","9.98","679631","4252450760"
"024880","케이피에프","7130","9520","2390","33.52","73466934","626960483890"
"042040","케이피엠테크","582","545","-37","-6.36","32868313","18314428933"
"054410","케이피티유","5750","6020","270","4.70","189680","1120073990"
"258610","케일럼","4670","4340","-330","-7.07","1559936","6582387030"
"274090","켄코아에어로스페이스","10700","11500","800","7.48","1184394","13333483900"
"402420","켈스","14950","14800","-150","-1.00","1364","18965200"
"217600","켐온","2765","2875","110","3.98","81361707","247141755390"
"089010","켐트로닉스","19000","21800","2800","14.74","1014309","20778005550"
"220260","켐트로스","6940","10050","3110","44.81","36402527","345297516180"
"176590","코나솔","5340","6190","850","15.92","72780","445938750"
"052400","코나아이","17000","18000","1000","5.88","1270917","22061110850"
"402030","코난테크놀로지","35500","25800","-9700","-27.32","8509458","260751841300"
"391710","코닉오토메이션","2690","4395","1705","63.38","45509680","169275787065"
"046070","코다코","1270","1310","40","3.15","1874617","2463289145"
"047770","코데즈컴바인","1860","2290","430","23.12","123815220","301352927395"
"078940","코드네이처","1665","1455","-210","-12.61","1741052","2604677515"
"080530","코디","1400","1555","155","11.07","1361274","2115037455"
"224060","코디엠","865","861","-4","-0.46","14789744","3056168983"
"417310","코람코더원리츠","5470","5400","-70","-1.28","852653","4456598880"
"357120","코람코에너지리츠","5800","5560","-240","-4.14","2587162","14257787540"
"104540","코렌텍","10350","10750","400","3.86","877410","8978286750"
"027050","코리아나","2950","3020","70","2.37","2215305","6593613115"
"290510","코리아센터","5040","5640","600","11.90","4002298","21328924110"
"007815","코리아써우","8010","8100","90","1.12","52057","424897050"
"007810","코리아써키트","19200","18650","-550","-2.86","5299455","105282229450"
"00781K","코리아써키트2우B","8550","8600","50","0.58","9785","83756180"
"190650","코리아에셋투자증권","9650","9920","270","2.80","2309295","24455868080"
"101670","코리아에스이","2055","2275","220","10.71","5579414","12146125050"
"123410","코리아에프티","2795","2915","120","4.29","4129498","11786048210"
"003690","코리안리","8510","8680","170","2.00","2621915","22912417450"
"036690","코맥스","3515","3795","280","7.97","649009","2344400985"
"049430","코메론","8920","9410","490","5.49","425860","3940815680"
"183300","코미코","47600","45800","-1800","-3.78","775709","36878498350"
"041960","코미팜","7190","7930","740","10.29","1948106","14121237980"
"089890","코세스","8620","10150","1530","17.75","4530160","44959604630"
"009730","코센","2715","2715","0","0.00","0","0"
"189350","코셋","2245","2185","-60","-2.67","4642","8602665"
"082660","코스나인","965","996","31","3.21","11719284","12102823356"
"192820","코스맥스","61700","67300","5600","9.08","2152917","146290499350"
"044820","코스맥스비티아이","9710","9430","-280","-2.88","551925","5166021240"
"222040","코스맥스엔비티","4480","5020","540","12.05","1591881","7649518550"
"241710","코스메카코리아","9730","9740","10","0.10","411460","4005342140"
"005070","코스모신소재","49650","62300","12650","25.48","18163706","1010617591900"
"005420","코스모화학","14650","22400","7750","52.90","49974206","940947919500"
"069110","코스온","2630","2630","0","0.00","0","0"
"169670","코스텍시스템","9600","11500","1900","19.79","126017","1369505150"
"071950","코아스","995","993","-2","-0.20","1428188","1383739542"
"166480","코아스템","10800","11150","350","3.24","606818","7041440300"
"045970","코아시아","6350","7430","1080","17.01","4380807","31669934910"
"196450","코아시아옵틱스","2000","1915","-85","-4.25","3137371","5966050935"
"029960","코엔텍","8210","8690","480","5.85","7617474","67173123180"
"002020","코오롱","22850","25750","2900","12.69","598705","14643992650"
"003070","코오롱글로벌","15800","18500","2700","17.09","3311582","63715436200"
"003075","코오롱글로벌우","27950","30350","2400","8.59","114138","3736496100"
"102940","코오롱생명과학","32800","39900","7100","21.65","881268","32753970600"
"002025","코오롱우","16100","17000","900","5.59","778592","15315168500"
"120110","코오롱인더","51700","54500","2800","5.42","2963015","155096170650"
"120115","코오롱인더우","27050","28500","1450","5.36","110139","3091606600"
"950160","코오롱티슈진","8010","8010","0","0.00","0","0"
"138490","코오롱플라스틱","10550","11850","1300","12.32","5649110","63547786780"
"056000","코원플레이","2860","2860","0","0.00","0","0"
"021240","코웨이","64900","64500","-400","-0.62","2426401","155379867900"
"033290","코웰패션","6200","6730","530","8.55","2540195","16384092270"
"056360","코위버","7010","7290","280","3.99","712020","4974283710"
"282880","코윈테크","24400","28550","4150","17.01","1413007","38041285300"
"121850","코이즈","3130","3820","690","22.04","43034986","160875143470"
"015710","코콤","4955","5170","215","4.34","338221","1719624065"
"052330","코텍","8620","9720","1100","12.76","1287418","12097551550"
"322780","코퍼스코리아","2365","2745","380","16.07","33066786","89022254350"
"126600","코프라","6420","6460","40","0.62","16573354","114121244040"
"036420","콘텐트리중앙","35750","41900","6150","17.20","3539557","132650286050"
"200130","콜마비앤에이치","26700","27600","900","3.37","1344792","36213105850"
"031820","콤텍시스템","770","861","91","11.82","9858555","7944616447"
"294570","쿠콘","32800","34950","2150","6.55","900423","30156859600"
"192400","쿠쿠홀딩스","15900","16950","1050","6.60","873197","14393499300"
"284740","쿠쿠홈시스","28150","31150","3000","10.66","381995","11399980850"
"317690","퀀타매트릭스","6010","6530","520","8.65","2824044","18997975830"
"365270","큐라클","19200","17750","-1450","-7.55","4327688","81114893500"
"060280","큐렉소","7430","8040","610","8.21","1179058","9363443210"
"015590","큐로","390","412","22","5.64","5467190","2217101397"
"040350","큐로컴","1105","1115","10","0.90","7049074","8319912025"
"051780","큐로홀딩스","500","502","2","0.40","4930230","2471195175"
"115180","큐리언트","30300","30300","0","0.00","0","0"
"182360","큐브엔터","13150","13750","600","4.56","1984372","27499447400"
"066310","큐에스아이","12100","12750","650","5.37","2505251","31058416550"
"136660","큐엠씨","2060","2590","530","25.73","9132","19006200"
"016600","큐캐피탈","567","557","-10","-1.76","22805692","12694028836"
"264900","크라운제과","8600","9790","1190","13.84","5003945","51978258360"
"26490K","크라운제과우","11000","12500","1500","13.64","1035940","13620469300"
"005740","크라운해태홀딩스","7110","7510","400","5.63","3536479","30068266050"
"005745","크라운해태홀딩스우","11450","11700","250","2.18","129854","1631528950"
"259960","크래프톤","237000","259000","22000","9.28","3969318","977517570500"
"096240","크레버스","23850","24300","450","1.89","426670","10488326500"
"215570","크로넥스","3200","2750","-450","-14.06","74295","198304770"
"043590","크로바하이텍","1515","1790","275","18.15","7249618","11739236035"
"114120","크루셜텍","1085","1085","0","0.00","0","0"
"110790","크리스에프앤씨","35500","35100","-400","-1.13","591544","20553799200"
"900250","크리스탈신소재","988","1130","142","14.37","80497213","90965943959"
"083790","크리스탈지노믹스","4190","4055","-135","-3.22","3427914","14333073225"
"045520","크린앤사이언스","10150","10350","200","1.97","211119","2220089750"
"036170","클라우드에어","1095","1240","145","13.24","14306256","18098926725"
"214150","클래시스","14500","15550","1050","7.24","6498768","102273429550"
"352770","클리노믹스","7700","8300","600","7.79","2812874","25356904690"
"237880","클리오","14400","14750","350","2.43","1209978","17449528700"
"139670","키네마스터","9290","11100","1810","19.48","5043361","58445282270"
"020120","키다리스튜디오","8260","10200","1940","23.49","28737297","290864644490"
"413600","키움제6호스팩","2275","2175","-100","-4.40","1339722","3002264675"
"039490","키움증권","79600","89000","9400","11.81","1559168","123716508000"
"054780","키이스트","7660","8720","1060","13.84","1189142","9853638490"
"336040","타스컴","19700","18600","-1100","-5.58","2262","42064700"
"219130","타이거일렉","16200","15950","-250","-1.54","727249","11458940050"
"318660","타임기술","2295","1740","-555","-24.18","54480","84223895"
"180060","탑선","13150","12400","-750","-5.70","132195","1626843100"
"065130","탑엔지니어링","5600","6150","550","9.82","442292","2694271970"
"134580","탑코미디어","7350","8760","1410","19.18","1677059","13633962000"
"014580","태경비케이","4125","4545","420","10.18","2694949","11458719955"
"015890","태경산업","6180","6670","490","7.93","7293092","49042733900"
"006890","태경케미컬","14350","13350","-1000","-6.97","6395897","91986647400"
"023160","태광","13050","16650","3600","27.59","10551776","153842321300"
"003240","태광산업","906000","886000","-20000","-2.21","6908","6154388000"
"011280","태림포장","3105","3340","235","7.57","2347710","7803073595"
"323280","태성","1890","1725","-165","-8.73","10695020","19275749730"
"053620","태양","8290","9060","770","9.29","1133656","10088003690"
"004100","태양금속","1415","1405","-10","-0.71","3831200","5246670480"
"004105","태양금속우","2525","2520","-5","-0.20","145020","360062310"
"116100","태양기계","1005","1000","-5","-0.50","15625","15003690"
"009410","태영건설","6760","7090","330","4.88","3680491","25806824910"
"009415","태영건설우","9700","11750","2050","21.13","1899537","22713052170"
"044490","태웅","9930","11200","1270","12.79","1466011","14871170250"
"124560","태웅로직스","5460","5170","-290","-5.31","11913946","60952926370"
"001420","태원물산","4950","5060","110","2.22","236792","1192730800"
"007980","태평양물산","1845","1815","-30","-1.63","1980230","3488343565"
"191420","테고사이언스","21700","20600","-1100","-5.07","381580","8117304250"
"073640","테라사이언스","1855","1720","-135","-7.28","9550797","16961487300"
"182690","테라셈","1440","1440","0","0.00","0","0"
"066700","테라젠이텍스","4455","4865","410","9.20","5950699","29005003420"
"095610","테스","20000","20300","300","1.50","1932603","38971194050"
"055490","테이팩스","68600","80300","11700","17.06","466996","34387337500"
"308700","테크엔","726","695","-31","-4.27","6718","4170539"
"089030","테크윙","7544","8110","566","7.50","9416196","139846177000"
"258050","테크트랜스","1185","1200","15","1.27","30924","34857800"
"054450","텔레칩스","14400","15450","1050","7.29","4151052","64226034150"
"091440","텔레필드","4130","3920","-210","-5.08","1317123","5296481685"
"078000","텔코웨어","9470","9850","380","4.01","60552","581673520"
"200230","텔콘RF제약","1540","1515","-25","-1.62","7528522","11543765755"
"214420","토니모리","4220","4140","-80","-1.90","2614443","11082050820"
"393210","토마토시스템","11850","10700","-1150","-9.70","5588","61575130"
"215480","토박스코리아","4610","4930","320","6.94","746397","3547164640"
"051360","토비스","9100","9250","150","1.65","1663682","15228032690"
"045340","토탈소프트","6140","6400","260","4.23","11437504","77758317100"
"108230","톱텍","7240","7800","560","7.73","1109082","8202490770"
"079970","투비소프트","1080","969","-111","-10.28","4184193","4139803816"
"199800","툴젠","70500","68700","-1800","-2.55","644787","44892218900"
"105550","트루윈","2580","2760","180","6.98","28612762","84368666095"
"290090","트윔","16400","19200","2800","17.07","1123047","20783656450"
"026150","특수건설","8650","11400","2750","31.79","13034219","139588588760"
"322180","티라유텍","8810","9250","440","4.99","218063","1989145130"
"117730","티로보틱스","7090","8010","920","12.98","12310641","96651230080"
"033830","티비씨","989","1085","96","9.71","10923994","11423696799"
"057680","티사이언티픽","2415","3205","790","32.71","49794737","159922774260"
"064760","티씨케이","113700","116700","3000","2.64","685501","82330974250"
"246710","티앤알바이오팹","15500","19950","4450","28.71","7444229","144034970100"
"340570","티앤엘","33700","37450","3750","11.13","1543184","55313235300"
"043220","티에스넥스젠","1130","1185","55","4.87","10071287","11773217860"
"277880","티에스아이","9580","10500","920","9.60","1510849","15140049910"
"131290","티에스이","60700","58100","-2600","-4.28","3115035","188041304400"
"019180","티에이치엔","3040","3290","250","8.22","1152556","3640688170"
"356860","티엘비","37150","40850","3700","9.96","1432903","56731928900"
"062860","티엘아이","7000","7060","60","0.86","254562","1759256940"
"363280","티와이홀딩스","18400","18900","500","2.72","1199192","21930360450"
"36328K","티와이홀딩스우","16450","18300","1850","11.25","55434","928963050"
"321550","티움바이오","16350","16800","450","2.75","1633825","28708760700"
"091810","티웨이항공","1990","2025","35","1.76","8741729","17440968910"
"004870","티웨이홀딩스","545","539","-6","-1.10","4780406","2548544570"
"104480","티케이케미칼","4060","4420","360","8.87","8858703","36795462355"
"081150","티플랙스","4290","4850","560","13.05","40818941","192837189950"
"130740","티피씨글로벌","2900","3195","295","10.17","2754587","8594225430"
"217880","틸론","11000","12800","1800","16.36","31255","350068740"
"084730","팅크웨어","13750","17000","3250","23.64","4281036","67973634350"
"046210","파나진","3105","2975","-130","-4.19","987063","3082540070"
"058530","파나케이아","1620","1620","0","0.00","0","0"
"034230","파라다이스","13700","15050","1350","9.85","11470424","154157092650"
"033540","파라텍","1555","1340","-215","-13.83","25573286","36537227440"
"043200","파루","1030","1180","150","14.56","6329148","6924473048"
"214450","파마리서치","65600","69300","3700","5.64","1746909","118816830400"
"217950","파마리서치바이오","32850","34000","1150","3.50","10901","351517150"
"208340","파멥신","4190","3805","-385","-9.19","4642604","17838186800"
"005690","파미셀","12200","13550","1350","11.07","24844751","326732988600"
"177830","파버나인","3890","4140","250","6.43","1652550","6682564735"
"037070","파세코","16650","14100","-2550","-15.32","3479206","52934563150"
"150900","파수","8960","9830","870","9.71","562633","5236820750"
"037030","파워넷","3765","4515","750","19.92","18198634","79640167425"
"047310","파워로직스","5770","6490","720","12.48","7627295","48955747270"
"266870","파워풀엑스","1295","1300","5","0.39","17735","23918350"
"368770","파이버프로","3790","4330","540","14.25","9790055","40643587280"
"170790","파이오링크","10900","11650","750","6.88","183927","2089610050"
"049120","파인디앤씨","1795","1945","150","8.36","4496457","8830902320"
"038950","파인디지털","5460","6020","560","10.26","5608592","32728666630"
"106240","파인테크닉스","11150","11150","0","0.00","13033037","152470205300"
"131760","파인텍","1100","1215","115","10.45","4336105","5074133380"
"065690","파커스","2595","2790","195","7.51","281112","750252540"
"140860","파크시스템스","97500","96900","-600","-0.62","563230","54321970600"
"091700","파트론","8560","8720","160","1.87","10127414","85378989040"
"202960","판도라티비","1385","1885","500","36.10","65452","107852935"
"032800","판타지오","640","759","119","18.59","10952305","8413146027"
"318010","팜스빌","12500","13550","1050","8.40","439007","5633171050"
"036580","팜스코","4985","5340","355","7.12","2352908","11825374395"
"027710","팜스토리","2825","2435","-390","-13.81","44289321","115924715120"
"004720","팜젠사이언스","7640","7780","140","1.83","4925858","41230923440"
"225590","패션플랫폼","1440","1605","165","11.46","14596542","24407856810"
"054300","팬스타엔터프라이즈","727","742","15","2.06","3243966","2329481070"
"068050","팬엔터테인먼트","3380","3760","380","11.24","4014399","14896267870"
"028670","팬오션","5590","5700","110","1.97","53849999","295917050870"
"222110","팬젠","6610","7450","840","12.71","509597","3887616590"
"010820","퍼스텍","3350","3980","630","18.81","98510092","387579642835"
"016800","퍼시스","32950","31650","-1300","-3.95","87180","2773947700"
"263750","펄어비스","52600","59300","6700","12.74","8580785","474113986800"
"251970","펌텍코리아","14900","16250","1350","9.06","294345","4646450500"
"001020","페이퍼코리아","1840","1780","-60","-3.26","10345241","18028709075"
"327610","펨토바이오메드","13900","13600","-300","-2.16","19946","280726700"
"087010","펩트론","10250","9330","-920","-8.98","1601936","15554342720"
"090080","평화산업","1380","1705","325","23.55","88651826","162011473365"
"010770","평화홀딩스","3300","3740","440","13.33","5063561","20790904535"
"119500","포메탈","4710","5240","530","11.25","7192113","36684539990"
"389140","포바이포","21650","20050","-1600","-7.39","18845917","436740206200"
"022100","포스코 ICT","5260","6120","860","16.35","16073174","91206662195"
"058430","포스코스틸리온","33450","39900","6450","19.28","1581676","59576901200"
"009520","포스코엠텍","5520","7250","1730","31.34","82280875","557717369150"
"047050","포스코인터내셔널","18350","22500","4150","22.62","15603019","308844036300"
"003670","포스코케미칼","109000","159000","50000","45.87","15977612","2151776947000"
"189690","포시에스","7320","7270","-50","-0.68","551210","3917977510"
"318020","포인트모바일","18100","18100","0","0.00","0","0"
"256630","포인트엔지니어링","2700","2550","-150","-5.56","948146","2459455615"
"331380","포커스에이치엔에스","2490","2585","95","3.82","1079740","2776131630"
"234100","폴라리스세원","2085","2380","295","14.15","48360838","115967984015"
"041020","폴라리스오피스","1360","1545","185","13.60","4154075","6394319935"
"114630","폴라리스우노","4045","4440","395","9.77","15420531","73338966105"
"290720","푸드나무","20350","24550","4200","20.64","1283253","30302786900"
"005670","푸드웰","6200","6930","730","11.77","4370160","31171431470"
"094940","푸른기술","8150","8530","380","4.66","1913829","15995403630"
"007330","푸른저축은행","8670","10450","1780","20.53","6035931","64259727490"
"017810","풀무원","12550","14550","2000","15.94","1544960","20814456300"
"093380","풍강","4070","4350","280","6.88","721896","3033064855"
"023900","풍국주정","15100","15500","400","2.65","378765","5753460200"
"103140","풍산","24150","27850","3700","15.32","2580380","67210210100"
"005810","풍산홀딩스","25000","28000","3000","12.00","429677","11348471200"
"371950","풍원정밀","15300","13750","-1550","-10.13","1665799","24955466600"
"370090","퓨런티어","30700","27700","-3000","-9.77","9605682","270934441000"
"220100","퓨쳐켐","16950","16200","-750","-4.42","2156288","35137126850"
"035200","프럼파스트","4235","4700","465","10.98","8700658","40798694590"
"334970","프레스티지바이오로직스","4480","4705","225","5.02","16669659","82271918800"
"950210","프레스티지바이오파마","11750","12000","250","2.13","3525216","43827676500"
"203690","프로스테믹스","2370","2035","-335","-14.14","3760189","7822437035"
"321260","프로이천","2020","2320","300","14.85","13645830","31518834040"
"303360","프로테옴텍","4490","6350","1860","41.43","70212","400159700"
"053610","프로텍","22250","24700","2450","11.01","1112223","26541514300"
"377220","프롬바이오","8640","9960","1320","15.28","24866764","243533892010"
"335810","프리시젼바이오","7190","8080","890","12.38","2901642","24070154250"
"053160","프리엠스","9620","9040","-580","-6.03","1881617","17783825530"
"041590","플래스크","1515","2135","620","40.92","35893263","65052866225"
"367000","플래티어","12550","13300","750","5.98","777220","10097784250"
"075130","플랜티넷","2700","2980","280","10.37","1054786","2995337525"
"222670","플럼라인생명과학","5140","5130","-10","-0.19","6953","36326040"
"009810","플레이그램","1220","1080","-140","-11.48","31445538","43917916475"
"237820","플레이디","5340","5970","630","11.80","1256360","7531733460"
"023770","플레이위드","8620","8540","-80","-0.93","2468575","21181543370"
"300080","플리토","30400","40950","10550","34.70","400357","15046134400"
"150440","피노텍","994","994","0","0.00","0","0"
"032580","피델릭스","1450","1615","165","11.38","11136074","17789669320"
"051380","피씨디렉트","14750","13900","-850","-5.76","4983895","82019374650"
"241820","피씨엘","21800","18550","-3250","-14.91","2534816","58209961350"
"237750","피앤씨테크","7630","6750","-880","-11.53","5460016","39806664190"
"024850","피에스엠씨","1025","1015","-10","-0.98","2007941","2049554421"
"319660","피에스케이","38800","35600","-3200","-8.25","3628408","136717595700"
"031980","피에스케이홀딩스","9140","8840","-300","-3.28","1457552","13466564120"
"002230","피에스텍","4200","4075","-125","-2.98","216576","904681340"
"057880","피에이치씨","1740","1740","0","0.00","0","0"
"043370","피에이치에이","7160","7170","10","0.14","1523612","11746688370"
"242350","피엔아이컴퍼니","5520","6300","780","14.13","70081","406967500"
"239890","피엔에이치테크","17350","16800","-550","-3.17","1129239","19879218750"
"347740","피엔케이피부임상연구센타","3925","6830","2905","74.01","51891140","470522417515"
"137400","피엔티","42200","53800","11600","27.49","5596231","257781204800"
"128660","피제이메탈","3900","4430","530","13.59","7638624","33268338020"
"006140","피제이전자","6250","7920","1670","26.72","5070465","39861569010"
"376180","피코그램","38500","51800","13300","34.55","20150856","915133354150"
"304840","피플바이오","8890","10000","1110","12.49","2957397","32583589290"
"062970","피피아이","2855","2940","85","2.98","420191","1194161890"
"087600","픽셀플러스","7860","8140","280","3.56","135382","1090312520"
"161580","필옵틱스","6950","7920","970","13.96","491521","3568594650"
"347770","핌스","13750","14050","300","2.18","619293","8558233500"
"163730","핑거","11850","12500","650","5.49","828510","10203394150"
"332710","하나금융14호스팩","2295","2295","0","0.00","0","0"
"341160","하나금융15호스팩","2280","2065","-215","-9.43","2073213","4344857655"
"343510","하나금융16호스팩","2200","2160","-40","-1.82","125068","272700990"
"388220","하나금융19호스팩","2140","2145","5","0.23","175802","376078835"
"400560","하나금융20호스팩","2280","2215","-65","-2.85","583164","1303917750"
"406760","하나금융21호스팩","2120","2115","-5","-0.24","157488","334544010"
"418170","하나금융22호스팩","2120","2115","-5","-0.24","237956","505826535"
"086790","하나금융지주","37200","39800","2600","6.99","33154329","1212541975115"
"299030","하나기술","51500","54900","3400","6.60","510681","27824143050"
"067310","하나마이크론","13200","12700","-500","-3.79","14469393","190455376700"
"372290","하나머스트7호스팩","2160","2150","-10","-0.46","235137","506236330"
"166090","하나머티리얼즈","43600","37400","-6200","-14.22","3988853","161411045450"
"293480","하나제약","17750","17900","150","0.85","314519","5580656500"
"039130","하나투어","53000","50000","-3000","-5.66","2873804","142721237350"
"136480","하림","3040","3000","-40","-1.32","21809849","64887630135"
"003380","하림지주","8340","8760","420","5.04","4935648","40399392250"
"365590","하이딥","1650","1760","110","6.67","24381862","41572131710"
"149980","하이로닉","7700","7640","-60","-0.78","3044314","22596226710"
"013030","하이록코리아","17100","22300","5200","30.41","2820960","55952356800"
"352820","하이브","164500","178500","14000","8.51","6452099","1089148032500"
"126700","하이비젼시스템","15250","16650","1400","9.18","2468268","39422571650"
"106080","하이소닉","5650","5650","0","0.00","0","0"
"071090","하이스틸","4260","4355","95","2.23","4403160","18446112655"
"377400","하이제6호스팩","2135","2165","30","1.41","244784","524570320"
"400840","하이제7호스팩","2130","2120","-10","-0.47","241529","513195130"
"221840","하이즈항공","4000","4175","175","4.38","1114351","4576578250"
"106190","하이텍팜","10000","9980","-20","-0.20","139401","1376217330"
"019490","하이트론","2470","2470","0","0.00","0","0"
"000080","하이트진로","30650","31400","750","2.45","4793616","144997015000"
"000087","하이트진로2우B","19150","18900","-250","-1.31","39620","736002800"
"000140","하이트진로홀딩스","11250","11700","450","4.00","529051","6193783300"
"000145","하이트진로홀딩스우","14350","15100","750","5.23","3851","56493350"
"373200","하인크코리아","10150","7370","-2780","-27.39","23873520","192503663730"
"066130","하츠","6270","7800","1530","24.40","6644333","51559008840"
"152550","한국ANKOR유전","1570","1595","25","1.59","244521","384839390"
"004590","한국가구","5830","6600","770","13.21","11381042","70994368050"
"036460","한국가스공사","35150","38000","2850","8.11","6850733","244232013750"
"039340","한국경제TV","5900","6270","370","6.27","556666","3356666030"
"005430","한국공항","38400","39100","700","1.82","108536","4091111300"
"071050","한국금융지주","61600","61800","200","0.32","4438577","269591970800"
"071055","한국금융지주우","57900","56100","-1800","-3.11","137499","7713165100"
"034950","한국기업평가","73400","72600","-800","-1.09","24337","1744558800"
"010040","한국내화","3190","3350","160","5.02","625998","2018628325"
"025540","한국단자","51900","58300","6400","12.33","282595","15815030300"
"222980","한국맥널티","6220","6380","160","2.57","5207227","34286390910"
"331660","한국미라클피플사","15150","13000","-2150","-14.19","1525","20711400"
"256840","한국비엔씨","8370","11350","2980","35.60","149522923","1814558968750"
"004090","한국석유","11600","11600","0","0.00","2960513","33343248650"
"025550","한국선재","4305","5040","735","17.07","8950989","42220466020"
"002200","한국수출포장","22950","23800","850","3.70","107098","2403687450"
"002960","한국쉘석유","245500","248500","3000","1.22","18627","4555974000"
"017890","한국알콜","9730","11250","1520","15.62","3112130","32646831800"
"000240","한국앤컴퍼니","12000","13150","1150","9.58","2061041","25268233900"
"080720","한국유니온제약","7220","8230","1010","13.99","629231","4962332010"
"123890","한국자산신탁","3450","3505","55","1.59","2021990","6927117300"
"015760","한국전력","22200","21700","-500","-2.25","21661132","473151177550"
"063570","한국전자금융","5010","5210","200","3.99","1173852","5931523480"
"041460","한국전자인증","5650","6210","560","9.91","5715230","34908983470"
"006200","한국전자홀딩스","1385","1470","85","6.14","3555752","5038402710"
"101680","한국정밀기계","1440","1440","0","0.00","0","0"
"039740","한국정보공학","3795","4325","530","13.97","11953701","50753398620"
"053300","한국정보인증","5790","6040","250","4.32","3377415","20615454940"
"025770","한국정보통신","7540","10400","2860","37.93","17620525","181379966970"
"409570","한국제10호스팩","2165","2145","-20","-0.92","104295","224623635"
"009540","한국조선해양","83300","93300","10000","12.00","4023822","341458575600"
"023350","한국종합기술","7440","7860","420","5.65","12265143","90858906510"
"025890","한국주강","2740","2740","0","0.00","474030","1268825760"
"000970","한국주철관","8120","8340","220","2.71","2406642","20327239410"
"104700","한국철강","6710","7090","380","5.66","1154197","7879433450"
"017960","한국카본","13000","15150","2150","16.54","17947264","250033884150"
"023760","한국캐피탈","779","808","29","3.72","1991299","1582209469"
"054040","한국컴퓨터","3725","3960","235","6.31","1177296","4575013140"
"050540","한국코퍼레이션","822","822","0","0.00","0","0"
"161890","한국콜마","38600","37550","-1050","-2.72","2022186","77246331550"
"024720","한국콜마홀딩스","17300","17000","-300","-1.73","405944","7081646100"
"021650","한국큐빅","3010","3185","175","5.81","2133055","6895597175"
"161390","한국타이어앤테크놀로지","32750","39800","7050","21.53","7518070","263037260000"
"053590","한국테크놀로지","703","767","64","9.10","16758728","13102380648"
"034830","한국토지신탁","1670","1685","15","0.90","18839722","30241288100"
"007280","한국특강","2495","2440","-55","-2.20","1135574","2730750590"
"032300","한국파마","25750","31800","6050","23.50","18083578","660059208900"
"168490","한국패러랠","2135","2180","45","2.11","681721","1488054670"
"037230","한국팩키지","3105","3435","330","10.63","12388156","45328164195"
"010100","한국프랜지","2505","2670","165","6.59","1019161","2567116700"
"047810","한국항공우주","49450","55200","5750","11.63","38416673","2098378212000"
"123690","한국화장품","7210","7260","50","0.69","587107","4195996620"
"003350","한국화장품제조","22400","22200","-200","-0.89","135389","2940092050"
"030520","한글과컴퓨터","17150","16600","-550","-3.21","2653935","45778526050"
"052600","한네트","7080","7820","740","10.45","12955537","100601961570"
"011500","한농화성","12300","14450","2150","17.48","1621820","21419873400"
"002390","한독","17700","18450","750","4.24","306435","5565170150"
"256150","한독크린텍","11000","10800","-200","-1.82","445047","4783202350"
"014790","한라","4015","4775","760","18.93","12738005","57069702355"
"092460","한라IMS","5140","5740","600","11.67","1336592","7213243010"
"060980","한라홀딩스","36250","38400","2150","5.93","333304","12681623200"
"053690","한미글로벌","11550","12400","850","7.36","6385284","74511774750"
"042700","한미반도체","12850","12700","-150","-1.17","10544395","143900968500"
"008930","한미사이언스","41000","41800","800","1.95","1622421","66261285000"
"128940","한미약품","322500","320000","-2500","-0.78","677512","211413909000"
"047080","한빛소프트","3225","3440","215","6.67","1459376","4800145395"
"009240","한샘","60800","54300","-6500","-10.69","1513630","85235387800"
"020000","한섬","30750","29150","-1600","-5.20","1682762","50320158800"
"003680","한성기업","6290","6690","400","6.36","6459078","44173871360"
"105630","한세실업","16900","17200","300","1.78","6886911","115704021800"
"069640","한세엠케이","3370","3535","165","4.90","1038550","4021318925"
"016450","한세예스24홀딩스","5860","5820","-40","-0.68","374628","2194902700"
"010420","한솔PNS","1560","1675","115","7.37","1260814","2014315235"
"009180","한솔로지스틱스","3280","3480","200","6.10","5204733","17330334265"
"070590","한솔인티큐브","1910","1950","40","2.09","990390","1896843020"
"213500","한솔제지","13300","14850","1550","11.65","2731277","38777962100"
"014680","한솔케미칼","214000","214000","0","0.00","1024755","223581233500"
"004710","한솔테크닉스","5170","6180","1010","19.54","6084604","36894191315"
"004150","한솔홀딩스","3080","3420","340","11.04","1831005","5983910385"
"025750","한솔홈데코","1330","1440","110","8.27","11596780","16134560965"
"226440","한송네오텍","1530","1530","0","0.00","0","0"
"042520","한스바이오메드","10150","10700","550","5.42","243943","2582681850"
"004960","한신공영","12150","13100","950","7.82","2421531","29318487200"
"011700","한신기계","9080","9410","330","3.63","40640869","364409566430"
"078350","한양디지텍","12900","14150","1250","9.69","1737823","23432616850"
"045100","한양이엔지","14000","14850","850","6.07","1548691","22517000250"
"001750","한양증권","10450","11250","800","7.66","165520","1777563500"
"001755","한양증권우","15150","17000","1850","12.21","6630","104440400"
"018880","한온시스템","10000","11150","1150","11.50","11488752","119822377720"
"009420","한올바이오파마","17000","17100","100","0.59","3235514","54495783000"
"014130","한익스프레스","5210","5190","-20","-0.38","633841","3269512345"
"046110","한일네트웍스","12000","12450","450","3.75","461286","5619227650"
"024740","한일단조","2745","3350","605","22.04","54527692","180987663630"
"005860","한일사료","6910","5180","-1730","-25.04","42931150","267825832760"
"300720","한일시멘트","13900","15350","1450","10.43","5902051","92889993850"
"123840","한일진공","599","597","-2","-0.33","1484998","902417285"
"002220","한일철강","3920","4280","360","9.18","1278448","5148927705"
"006390","한일현대시멘트","22450","25250","2800","12.47","335345","8454752850"
"003300","한일홀딩스","10800","11250","450","4.17","59353","642360450"
"007770","한일화학","21700","20150","-1550","-7.14","2957644","61288276100"
"051600","한전KPS","38300","41950","3650","9.53","4477346","173078253750"
"052690","한전기술","68000","73300","5300","7.79","5454733","358280642500"
"130660","한전산업","10800","11000","200","1.85","4217947","44306385070"
"107640","한중엔시에스","11500","12950","1450","12.61","1899","22252350"
"002320","한진","28150","26550","-1600","-5.68","677316","18345135600"
"003480","한진중공업홀딩스","4125","4090","-35","-0.85","1378627","5540315015"
"180640","한진칼","59400","60700","1300","2.19","1239261","73621813700"
"18064K","한진칼우","33700","33400","-300","-0.89","30315","991738900"
"005110","한창","970","1160","190","19.59","211591248","236503645518"
"043090","한창바이오텍","1925","4590","2665","138.44","55172566","225481085650"
"079170","한창산업","7640","8490","850","11.13","12699897","117120299310"
"009460","한창제지","1635","1720","85","5.20","5513617","9461001565"
"086960","한컴MDS","12200","17150","4950","40.57","11810432","193838047700"
"372910","한컴라이프케어","5190","5490","300","5.78","3715073","20936109470"
"054920","한컴위드","4990","5330","340","6.81","8182464","45521636255"
"002680","한탑","2470","1870","-600","-24.29","28026662","58861835490"
"000880","한화","24750","30800","6050","24.44","8307312","228656890200"
"00088K","한화3우B","14100","15700","1600","11.35","1101621","16390231350"
"088350","한화생명","2170","2320","150","6.91","32226551","70953940665"
"000370","한화손해보험","4120","4935","815","19.78","15263851","73430847675"
"009830","한화솔루션","34600","46300","11700","33.82","56085815","2304476349000"
"009835","한화솔루션우","35550","49300","13750","38.68","2890964","139755270000"
"272210","한화시스템","12800","15350","2550","19.92","18376347","259769868300"
"012450","한화에어로스페이스","44600","69600","25000","56.05","39657366","2440531126650"
"000885","한화우","33300","37500","4200","12.61","33799","1217894300"
"003530","한화투자증권","3275","3365","90","2.75","21925935","71990327260"
"003535","한화투자증권우","7690","7450","-240","-3.12","227321","1675456520"
"386580","한화플러스제2호스팩","2205","2200","-5","-0.23","406209","891493440"
"195870","해성디에스","56900","56000","-900","-1.58","6314317","370714671000"
"034810","해성산업","10500","11900","1400","13.33","828561","8961663890"
"03481K","해성산업1우","14600","15950","1350","9.25","218480","3345310550"
"076610","해성옵틱스","827","757","-70","-8.46","10707867","8427649393"
"059270","해성티피씨","6280","7830","1550","24.68","11966382","95062340930"
"101530","해태제과식품","7060","7240","180","2.55","3475657","28469604780"
"220180","핸디소프트","4255","4175","-80","-1.88","13394560","67914412795"
"143210","핸즈코퍼레이션","4010","4145","135","3.37","351477","1455259220"
"900270","헝셩그룹","368","343","-25","-6.79","10024233","3524109300"
"214180","헥토이노베이션","14650","15250","600","4.10","484297","7335318500"
"234340","헥토파이낸셜","18950","22500","3550","18.73","985514","21121810000"
"084990","헬릭스미스","19650","18400","-1250","-6.36","3147065","58095686750"
"000720","현대건설","39550","46600","7050","17.83","12690318","533112771600"
"267270","현대건설기계","42600","40200","-2400","-5.63","4158169","162131428800"
"000725","현대건설우","70700","73300","2600","3.68","78167","5419004900"
"170030","현대공업","6940","7890","950","13.69","24496541","189904838700"
"005440","현대그린푸드","7720","7890","170","2.20","2668173","20469594510"
"086280","현대글로비스","180000","181500","1500","0.83","2222905","402860137000"
"042670","현대두산인프라코어","5320","5820","500","9.40","23876065","131445176940"
"064350","현대로템","19300","24950","5650","29.27","153442956","3771413875700"
"079430","현대리바트","11100","11600","500","4.50","631017","7139175700"
"012330","현대모비스","204500","224000","19500","9.54","4886018","1077806636908"
"319400","현대무벡스","3050","3210","160","5.25","23012432","73329940305"
"010620","현대미포조선","80500","106500","26000","32.30","6713930","627682598406"
"048410","현대바이오","24700","28800","4100","16.60","15225059","428210214550"
"052260","현대바이오랜드","11800","14800","3000","25.42","8063106","127922879100"
"069960","현대백화점","67100","67300","200","0.30","1335567","87698697200"
"004560","현대비앤지스틸","12650","14000","1350","10.67","1538331","20556009150"
"004565","현대비앤지스틸우","63300","60900","-2400","-3.79","5844","356518200"
"004310","현대약품","5840","5530","-310","-5.31","58802763","362190741340"
"322000","현대에너지솔루션","32200","55600","23400","72.67","17209126","821888008850"
"041440","현대에버다임","9650","8210","-1440","-14.92","29378824","260028950200"
"039010","현대에이치티","8140","8670","530","6.51","143458","1222484810"
"017800","현대엘리베이","26350","30000","3650","13.85","2576595","70942091850"
"307950","현대오토에버","113500","126000","12500","11.01","1260941","157077389500"
"011210","현대위아","55600","70000","14400","25.90","5914186","375978466200"
"090850","현대이지웰","7580","7720","140","1.85","4403053","35243095050"
"267260","현대일렉트릭","23900","30450","6550","27.41","11468623","295808130950"
"004020","현대제철","32750","34500","1750","5.34","9137868","300813892000"
"329180","현대중공업","125500","140000","14500","11.55","5053730","642308069500"
"005380","현대차","178000","193500","15500","8.71","19882968","3794578441904"
"005387","현대차2우B","86400","92500","6100","7.06","1586617","146446040098"
"005389","현대차3우B","83600","88500","4900","5.86","128491","11386361000"
"005385","현대차우","87000","91900","4900","5.63","916122","84427336900"
"001500","현대차증권","9670","10500","830","8.58","743840","7604490790"
"011760","현대코퍼레이션","15500","17400","1900","12.26","1211833","19886646350"
"227840","현대코퍼레이션홀딩스","10500","11550","1050","10.00","463884","5052720650"
"126560","현대퓨처넷","2505","2835","330","13.17","28326551","84965919640"
"001450","현대해상","30650","33550","2900","9.46","7511911","246091266750"
"057050","현대홈쇼핑","50700","51400","700","1.38","209066","10680119050"
"092300","현우산업","4340","4735","395","9.10","16705817","77615652945"
"138360","협진","4480","4480","0","0.00","0","0"
"011080","형지I&C","872","699","-173","-19.84","3370933","2784450318"
"093240","형지엘리트","1595","1720","125","7.84","8022919","13783596600"
"003010","혜인","8530","7890","-640","-7.50","15036739","117266504020"
"111110","호전실업","8290","9040","750","9.05","751394","6558273800"
"008770","호텔신라","69700","72900","3200","4.59","4118355","289832010200"
"008775","호텔신라우","56800","59600","2800","4.93","35475","2079076200"
"060560","홈센타홀딩스","1270","1475","205","16.14","93744665","131034491585"
"064240","홈캐스트","3575","4795","1220","34.13","5075045","20317031895"
"039610","화성밸브","5340","6740","1400","26.22","17639970","119851595250"
"002460","화성산업","18850","17500","-1350","-7.16","1203387","21102917500"
"378850","화승알앤에이","3470","3480","10","0.29","834672","2849402625"
"241590","화승엔터프라이즈","11750","12200","450","3.83","3754044","44600880200"
"006060","화승인더","4665","5040","375","8.04","2658261","13030294590"
"013520","화승코퍼레이션","1525","1485","-40","-2.62","2856223","4083323775"
"010690","화신","8780","9950","1170","13.33","20123779","198821533520"
"126640","화신정공","1610","1760","150","9.32","8008204","13630438565"
"133820","화인베스틸","2605","3005","400","15.36","3404394","8885196495"
"061250","화일약품","2620","2695","75","2.86","47122004","138118880900"
"010660","화천기계","2570","3215","645","25.10","23923234","77905418975"
"000850","화천기공","31950","34250","2300","7.20","122753","4243562400"
"016580","환인제약","16750","17200","450","2.69","403261","6818972800"
"032560","황금에스티","7320","7770","450","6.15","2474016","18478761150"
"004800","효성","76500","75400","-1100","-1.44","897277","66815686300"
"094280","효성ITX","14300","15000","700","4.90","161230","2383157800"
"097870","효성오앤비","9760","9730","-30","-0.31","4289661","40964903050"
"298040","효성중공업","57100","65900","8800","15.41","1052864","61738798100"
"298050","효성첨단소재","363500","423500","60000","16.51","894391","326905696748"
"298020","효성티앤씨","330000","341500","11500","3.48","768018","245466628500"
"298000","효성화학","176500","188500","12000","6.80","215315","38715416500"
"093370","후성","17700","15850","-1850","-10.45","58758333","995618929900"
"081660","휠라홀딩스","28500","30100","1600","5.61","4516340","133741897400"
"290270","휴네시온","4185","4430","245","5.85","250753","1092199535"
"005870","휴니드","7100","8100","1000","14.08","3843223","29381615040"
"353190","휴럼","1170","1325","155","13.25","10384675","13492569890"
"090710","휴림로봇","3000","3180","180","6.00","405609408","1248138951660"
"205470","휴마시스","18300","18900","600","3.28","124323688","2623072552000"
"115160","휴맥스","3330","3755","425","12.76","13321825","50344988135"
"028080","휴맥스홀딩스","3380","3510","130","3.85","2140205","7877391340"
"032860","휴먼엔","3640","3640","0","0.00","0","0"
"200670","휴메딕스","21600","24450","2850","13.19","1039641","24743086650"
"212310","휴벡셀","6000","5950","-50","-0.83","37076","211954820"
"079980","휴비스","6270","6390","120","1.91","487521","3105824080"
"065510","휴비츠","10950","10650","-300","-2.74","6585014","73188485550"
"215090","휴센텍","1505","1505","0","0.00","0","0"
"005010","휴스틸","4390","4335","-55","-1.25","6623438","27133590425"
"263920","휴엠앤씨","4555","4555","0","0.00","0","0"
"243070","휴온스","35950","38000","2050","5.70","357186","13222491400"
"084110","휴온스글로벌","21800","22900","1100","5.05","1000951","23474915600"
"145020","휴젤","109800","129500","19700","17.94","2414485","303557735300"
"024060","흥구석유","6170","6240","70","1.13","1702926","10463635260"
"010240","흥국","6900","7190","290","4.20","991699","6766573350"
"189980","흥국에프엔비","2910","3200","290","9.97","12025315","38723942990"
"000540","흥국화재","3190","3400","210","6.58","2945567","9472655260"
"000547","흥국화재2우B","22700","22150","-550","-2.42","13346","288922800"
"000545","흥국화재우","7070","7170","100","1.41","17935","126062930"
"003280","흥아해운","2095","1830","-265","-12.65","12589311","23239471385"
"037440","희림","8100","10150","2050","25.31","75014045","678670021810"
"238490","힘스","6240","7670","1430","22.92","3846745","29775643600"